date,new_confirmed,new_deceased,new_tested,cumulative_confirmed,cumulative_deceased,cumulative_tested,new_hospitalized_patients,cumulative_hospitalized_patients,current_hospitalized_patients,current_ventilator_patients,new_persons_vaccinated,cumulative_persons_vaccinated,new_persons_fully_vaccinated,cumulative_persons_fully_vaccinated,mobility_retail_and_recreation,mobility_grocery_and_pharmacy,mobility_parks,mobility_transit_stations,mobility_workplaces,mobility_residential,stringency_index,average_temperature_celsius,minimum_temperature_celsius,maximum_temperature_celsius,rainfall_mm,dew_point,relative_humidity
3/31/2020,4463,662,11896,38025,4434,155174,2834,23549,12597,,,,,,-74,-30,-21,-72,-70,27,79.63,5.422222,2.172222,7.827778,0.127,1.905556,78.282
4/1/2020,4891,769,11947,42916,5203,167237,3565,27114,13637,,,,,,-75,-32,-29,-73,-69,28,79.63,6.166667,3.294444,8.777778,0,1.911111,74.710765
4/2/2020,4824,805,13623,47740,6008,182352,3284,30398,13875,1813,,,,,-75,-32,-24,-73,-70,29,79.63,7.116667,2.644444,10.455556,0.1905,2.133333,71.40378
4/3/2020,4853,840,14629,52593,6848,223578,2932,33330,15546,2120,,,,,-76,-30,-25,-72,-69,29,79.63,5.266667,1.672222,8.377778,0.169333,1.211111,75.85694
4/4/2020,3976,906,16080,56569,7754,239658,2922,36252,17501,2309,,,,,-81,-36,-38,-72,-57,19,79.63,7.617284,3.888889,10.259259,0.762,3.851852,77.565791
4/5/2020,3556,917,13238,60125,8671,252896,2913,39165,18854,2469,,,,,-82,-41,-29,-70,-54,15,79.63,11.438272,3.438272,17.074074,0,3.191358,57.053666
4/6/2020,5273,895,13775,65398,9566,267303,3047,42212,19492,2644,,,,,-73,-31,-20,-72,-70,27,79.63,10.055556,4.9,13.105556,1.36525,4.011111,66.948495
4/7/2020,5477,998,14423,70875,10564,281726,3150,45362,20233,2864,,,,,-73,-29,-7,-69,-70,27,79.63,8.744444,1.188889,15.277778,0,2.627778,66.032842
4/8/2020,5146,1077,16443,76021,11641,298169,2966,48328,20739,2967,,,,,-73,-27,-14,-70,-70,27,79.63,10.272222,2.166667,16.45,0,4.05,65.659246
4/9/2020,4875,1002,19116,80896,12643,316836,2631,50959,21004,2963,,,,,-71,-20,-13,-70,-70,27,79.63,7.9,4.872222,11.227778,0.028222,5.844444,87.009748
4/10/2020,4327,944,18091,85223,13587,334974,2460,53419,21279,3228,,,,,-78,-33,-18,-75,-80,32,79.63,12.104938,5.882716,18.32716,0,7.62963,74.233376
4/11/2020,3585,956,18000,88808,14543,352974,2162,55581,21253,3274,,,,,-81,-32,-37,-70,-57,19,79.63,12.753086,7.006173,17.228395,0.254,7.944444,72.808295
4/12/2020,3507,957,14506,92315,15500,367667,2065,57646,21685,3301,,,,,-89,-63,-33,-71,-58,16,79.63,8.111111,3.141975,12.364198,0,4.796296,79.87118
4/13/2020,4203,896,14982,96518,16396,382650,2162,59808,21306,3277,,,,,-78,-41,-21,-78,-83,31,79.63,3.911111,-0.555556,6.344444,0,-2.833333,61.861332
4/14/2020,4335,859,15994,100853,17255,398916,2088,61896,21279,3234,,,,,-71,-26,-10,-69,-70,27,79.63,4.977778,-3.305556,11.866667,0,-0.794444,66.771593
4/15/2020,5070,878,18665,105923,18133,417649,1880,63776,20581,3228,,,,,-72,-27,-6,-69,-69,27,79.63,9.544444,1.138889,16.855556,0,2.838889,63.99601
4/16/2020,5292,843,21328,111215,18976,438991,2011,65787,20388,3222,,,,,-73,-27,-7,-70,-69,28,79.63,8.466667,3.45,12.977778,0,4.238889,75.088382
4/17/2020,4977,819,21389,116192,19795,460437,1966,67753,19329,3162,,,,,-75,-30,-33,-71,-68,29,79.63,6.944444,3.805556,9.972222,0,2.772222,75.099986
4/18/2020,4744,800,21626,120936,20595,482063,1630,69383,19455,3247,,,,,-81,-37,-47,-71,-54,19,79.63,5.981481,2.141975,10.395062,0,1.290123,72.142285
4/19/2020,3881,770,19316,124817,21365,501379,1657,71040,19573,3176,,,,,-80,-40,-12,-66,-49,14,79.63,6.975309,1.154321,12.67284,0,1.358025,67.690595
4/20/2020,4441,783,17970,129258,22148,537121,1736,72776,19330,3130,,,,,-71,-30,-2,-68,-67,25,79.63,7.488889,2.322222,11.727778,0,1.366667,65.549103
4/21/2020,4795,745,22814,134053,22893,559935,1712,74488,19138,3036,,,,,-72,-28,2,-67,-67,26,79.63,8.65,3.727778,13.372222,0,3.127778,68.833998
4/22/2020,5517,731,23560,139570,23624,583496,1530,76018,18532,2964,,,,,-72,-28,1,-67,-66,27,79.63,9.516667,4.255556,15.255556,0,4.327778,70.504974
4/23/2020,5167,678,28532,144737,24302,612031,1512,77530,17866,2867,,,,,-72,-27,6,-67,-66,27,79.63,9.488889,4.216667,15.127778,0,3.661111,67.328272
4/24/2020,4961,682,28760,149698,24984,640792,1525,79055,17062,2703,,,,,-73,-26,-4,-66,-65,27,79.63,9.161111,2.205556,16.655556,0,2.611111,64.289905
4/25/2020,3757,646,29058,153455,25630,669850,1252,80307,16602,2702,,,,,-78,-32,-23,-65,-51,18,79.63,10.228395,4.518519,16.907407,0,4.450617,67.793133
4/26/2020,3476,633,31610,156931,26263,701460,1355,81662,16553,2580,,,,,-78,-37,-10,-64,-48,14,79.63,9.641975,4.12963,14.493827,0.0635,5.388889,75.237648
4/27/2020,4739,595,33287,161670,26858,734860,1536,83198,16660,2460,,,,,-69,-29,-3,-66,-65,25,79.63,7.683333,3.411111,12.277778,0.616857,2.161111,68.3125
4/28/2020,4719,559,45505,166389,27417,780366,1518,84716,15875,2353,,,,,-74,-33,-42,-71,-66,25,79.63,6.044444,2.55,8.816667,0,2.316667,77.32143
4/29/2020,5433,573,66793,171822,27990,849296,1488,86204,15520,2286,,,,,-73,-30,-31,-69,-66,27,79.63,6.211111,3.655556,8.355556,0.653143,3.944444,85.607884
4/30/2020,4961,551,84215,176783,28541,933455,1442,87646,15163,2224,,,,,-74,-28,-31,-69,-66,27,79.63,7.572222,4.205556,10.344444,2.866571,4.577778,81.72977
5/1/2020,4766,568,74893,181549,29109,1008348,1262,88908,14722,2178,,,,,-74,-27,-22,-67,-64,27,79.63,7.6,3.144444,11.288889,1.233714,4.655556,81.994684
5/2/2020,3258,494,63559,184807,29603,1071909,1180,90088,14379,2068,,,,,-78,-30,-18,-63,-49,17,79.63,9.17284,4.407407,13.709877,4.445,4.82716,74.549251
5/3/2020,3002,450,68817,187809,30053,1140726,1187,91275,14186,2009,,,,,-79,-37,-21,-64,-46,14,79.63,8.469136,3.734568,12.876543,0.042333,5.481481,81.626892
5/4/2020,3398,484,73068,191207,30537,1220764,1249,92524,14096,1936,,,,,-69,-27,4,-64,-64,24,79.63,7.933333,2.366667,11.1,2.394857,4.727778,80.333058
5/5/2020,3686,465,67444,194893,31002,1283443,1146,93670,13722,1874,,,,,-70,-25,4,-64,-64,25,79.63,6.644444,1.066667,11.283333,0.028222,1.805556,71.580791
5/6/2020,3832,460,74761,198725,31462,1360595,1203,94873,13146,1802,,,,,-69,-22,16,-62,-63,25,79.63,8.522222,-0.444444,15.344444,0,1.155556,60.102714
5/7/2020,3787,461,78912,202512,31923,1439506,1166,96039,12625,1685,,,,,-67,-15,16,-62,-63,25,79.63,11.872222,2.522222,18.916667,0.108857,4.894444,62.474008
5/8/2020,3064,384,77892,205576,32307,1517402,909,96948,12052,1642,,,,,-75,-28,14,-68,-77,30,79.63,12.777778,6.364198,18.104938,0.09525,8.345679,74.722147
5/9/2020,2170,379,77202,207746,32686,1594604,944,97892,12014,1585,,,,,-78,-29,-6,-62,-48,17,79.63,13.808642,6.740741,19.950617,0,8.111111,68.536424
5/10/2020,2337,348,76942,210083,33034,1671546,915,98807,11726,1538,,,,,-80,-37,-38,-68,-45,14,79.63,5.580247,1.487654,9.876543,0.296333,0.888889,72.020859
5/11/2020,3612,309,70360,213695,33343,1741989,1029,99836,11966,1485,,,,,-67,-25,-8,-64,-62,24,77.78,4.811111,0.244444,8.888889,0.326571,-1.661111,63.190558
5/12/2020,3410,321,74859,217105,33664,1816848,982,100818,11590,1414,,,,,-68,-23,7,-62,-62,24,77.78,6.622222,0.188889,12.888889,0.127,0.566667,65.889298
5/13/2020,3330,317,83472,220435,33981,1901014,966,101784,11341,1342,,,,,-68,-23,6,-62,-61,25,71.3,4.422222,-0.383333,8.227778,0.4445,-1.288889,66.639023
5/14/2020,2630,334,85166,223065,34315,1986193,907,102691,10919,1314,,,,,-67,-21,28,-61,-61,23,71.3,7.427778,-0.9,13.588889,0,0.127778,60.358971
5/15/2020,2530,314,93934,225595,34629,2082174,868,103559,10690,1337,,,,,-69,-21,21,-60,-60,24,71.3,9.094444,3.616667,13.405556,0,2.816667,65.43294
5/16/2020,2082,314,93353,227677,34943,2175527,813,104372,10237,1234,,,,,-74,-25,5,-58,-43,15,71.3,9.265432,4.265432,13.67284,0,4.080247,70.851966
5/17/2020,1837,266,82141,229514,35209,2257668,792,105164,10198,1196,,,,,-74,-29,27,-55,-39,12,71.3,10.864198,8.228395,13.537037,0.0508,7.351852,79.731417
5/18/2020,2581,293,72532,232095,35502,2330252,848,106012,10230,1141,,,,,-63,-20,36,-59,-59,22,71.3,11.916667,10.416667,14.277778,1.354667,9.438272,82.135475
5/19/2020,3063,275,88126,235158,35777,2410097,880,106892,10012,1106,,,,,-64,-18,51,-57,-59,22,71.3,13.416667,10.611111,16.388889,2.939143,11.123457,83.422907
5/20/2020,2719,270,87819,237877,36047,2497915,850,107742,9562,1034,,,,,-64,-16,68,-56,-59,22,71.3,16.338889,8.394444,24.188889,0.1524,9.666667,64.795932
5/21/2020,2567,239,107919,240444,36286,2605843,841,108583,9292,1008,,,,,-64,-16,51,-58,-59,23,71.3,14.4,8.138889,18.677778,0,7.005556,61.371995
5/22/2020,2057,223,92143,242501,36509,2697987,740,109323,9183,964,,,,,-66,-18,14,-59,-58,24,71.3,13.072222,9.844444,16.105556,3.2385,7.411111,69.78986
5/23/2020,1532,220,92312,244033,36729,2790296,643,109966,8813,928,,,,,-72,-23,-12,-59,-41,15,71.3,10.533333,8.45,12.855556,1.890889,5.327778,71.249124
5/24/2020,1373,197,59633,245406,36926,2849932,587,110553,8813,886,,,,,-71,-25,38,-52,-36,11,71.3,12.339506,8.567901,15.08642,1.850571,9.256944,78.240846
5/25/2020,1625,200,78478,247031,37126,2998370,602,111155,8835,863,,,,,-64,-23,136,-60,-77,24,71.3,13.538889,6.027778,19.244444,0.141111,6.077778,61.827712
5/26/2020,2070,214,78099,249101,37340,3076645,698,111853,8731,847,,,,,-60,-14,66,-55,-59,21,71.3,14.177778,8.666667,18.961111,0,8.311111,68.241475
5/27/2020,1825,198,83014,250926,37538,3159661,712,112565,8219,783,,,,,-61,-15,65,-55,-58,22,71.3,11.8,5.3,17.233333,0.0254,5.305556,64.575278
5/28/2020,1757,217,102734,252683,37755,3262396,702,113267,7906,751,,,,,-60,-12,77,-55,-58,22,71.3,15.055556,5.688889,22.277778,0,7.472222,60.657517
5/29/2020,1531,186,106552,254214,37941,3368948,614,113881,7585,719,,,,,-62,-12,67,-53,-56,22,69.44,17.138889,9.305556,23.333333,0,7.277778,52.392222
5/30/2020,1132,163,97387,255346,38104,3466338,568,114449,7267,704,,,,,-69,-16,48,-49,-31,12,69.44,13.537037,7.191358,19.055556,0,5.567901,58.693095
5/31/2020,1080,127,105434,256426,38231,3638278,528,114977,7237,679,,,,,-67,-19,67,-45,-26,9,69.44,14.098765,6.858025,20.783951,0,6.87037,61.928473
6/1/2020,1439,134,101571,257865,38365,3739808,605,115582,7247,652,,,,,-56,-13,74,-51,-53,19,67.59,14.611111,7.333333,20.127778,0.0254,6.833333,59.809071
6/2/2020,1492,168,129183,259357,38533,3869621,668,116250,7086,636,,,,,-59,-15,78,-51,-54,19,67.59,15.294444,7.438889,22.088889,0,6.927778,58.002862
6/3/2020,1369,155,143443,260726,38688,4011931,632,116882,6815,602,,,,,-62,-19,0,-57,-54,22,67.59,9.705556,7.438889,12.566667,7.511143,7.511111,86.352376
6/4/2020,1249,134,144224,261975,38822,4157311,563,117445,6579,571,,,,,-61,-17,19,-56,-54,22,67.59,8.55,5.938889,11.977778,1.197429,5.716667,82.695007
6/5/2020,1123,123,145009,263098,38945,4304282,475,117920,6378,554,,,,,-63,-17,9,-56,-53,22,67.59,8.061111,4.961111,11.894444,6.894286,3.644444,74.030854
6/6/2020,804,111,117581,263902,39056,4422335,407,118327,6148,540,,,,,-70,-22,-17,-57,-33,14,67.59,9.444444,5.816667,12.911111,7.765143,5.962963,75.947783
6/7/2020,722,128,104122,264624,39184,4527480,406,118733,5943,515,,,,,-67,-23,22,-51,-28,10,67.59,9.411111,6.633333,11.466667,2.576286,6.972222,84.917873
6/8/2020,1099,125,98445,265723,39309,4662107,412,119145,5930,509,,,,,-56,-17,44,-54,-52,19,73.15,8.738889,4.755556,12.205556,0.6858,3.933333,71.978474
6/9/2020,1165,90,133102,266888,39399,4795468,491,119636,5736,491,,,,,-58,-17,56,-53,-52,20,73.15,10.222222,3.044444,14.288889,0,5.977778,75.167037
6/10/2020,1196,110,145509,268084,39509,4941550,511,120147,5475,439,,,,,-61,-19,-1,-58,-52,21,73.15,10.216667,8.283333,12.377778,3.265714,9,89.025703
6/11/2020,1013,81,149344,269097,39590,5092695,446,120593,5179,390,,,,,-59,-17,15,-58,-52,21,73.15,10.261111,8.855556,12.544444,2.757714,8.072222,86.471631
6/12/2020,1053,80,147099,270150,39670,5241174,393,120986,5090,393,,,,,-61,-17,6,-57,-51,21,73.15,11.155556,9.588889,12.833333,5.842,9.727778,91.047148
6/13/2020,886,62,120409,271036,39732,5364875,385,121371,4941,390,,,,,-65,-17,41,-49,-24,11,73.15,13.966667,10.716667,17.894444,2.394857,12.993827,91.566942
6/14/2020,826,86,83965,271862,39818,5449760,364,121735,4908,393,,,,,-63,-20,65,-46,-19,8,73.15,14.755556,10.605556,19.444444,0.6858,12.166667,84.857184
6/15/2020,1045,71,101337,272907,39889,5552801,439,122174,4870,385,,,,,-46,-14,63,-50,-50,18,71.3,15.655556,12.477778,19.922222,0.0254,13.305556,85.971726
6/16/2020,1103,85,122435,274010,39974,5675283,455,122629,4863,378,,,,,-50,-13,53,-51,-50,19,71.3,15.288889,12.144444,19.005556,2.3114,13.15,87.141908
6/17/2020,1017,59,131631,275027,40033,5808862,431,123060,4719,357,,,,,-52,-14,34,-52,-50,19,71.3,14.655556,11.4,19.266667,1.6764,12.494444,86.965616
6/18/2020,1022,61,135854,276049,40094,5948476,402,123462,4560,352,,,,,-54,-15,8,-56,-52,20,71.3,12.488889,10.75,15.066667,0.834571,10.888889,90.030281
6/19/2020,993,52,133535,277042,40146,6082480,336,123798,4414,330,,,,,-53,-11,20,-52,-50,19,71.3,13.561111,11.011111,16.744444,3.846286,11.916667,89.906148
6/20/2020,683,60,117971,277725,40206,6201735,258,124056,4253,346,,,,,-57,-10,49,-43,-20,9,71.3,15.111111,10.5,18.855556,2.921,10.583333,74.727821
6/21/2020,636,54,76514,278361,40260,6278432,288,124344,4223,310,,,,,-58,-17,37,-44,-14,7,71.3,14.077778,10.516667,16.911111,2.576286,10.583333,79.92421
6/22/2020,899,64,102957,279260,40324,6384549,392,124736,4282,340,,,,,-45,-13,72,-49,-51,17,71.3,14.094444,8.222222,17.872222,1.467556,9.894444,76.570456
6/23/2020,883,65,130680,280143,40389,6507342,362,125098,4135,311,,,,,-48,-10,90,-48,-51,17,71.3,17.755556,13.633333,21.411111,0.7874,13.316667,75.98632
6/24/2020,777,74,140303,280920,40463,6648415,367,125465,4031,316,,,,,-49,-8,98,-47,-49,17,71.3,20.188889,12.3,26.377778,0.0508,14.155556,68.441209
6/25/2020,726,68,155176,281646,40531,6847145,324,125789,3851,276,,,,,-49,-6,102,-47,-49,17,71.3,20.127778,12.883333,25.95,0,13.111111,64.197439
6/26/2020,666,42,144928,282312,40573,6992073,338,126127,3621,268,,,,,-51,-9,50,-48,-49,18,71.3,18.561111,11.727778,24.855556,3.556,14.372222,76.727392
6/27/2020,653,51,117741,282965,40624,7109814,286,126413,3545,270,,,,,-59,-15,-7,-49,-24,11,71.3,14.122222,10.894444,17.638889,4.426857,12.277778,88.820117
6/28/2020,449,45,90229,283414,40669,7208646,208,126621,3558,270,,,,,-56,-19,22,-46,-17,8,71.3,11.516667,10.127778,13.638889,9.724571,8.833333,84.085995
6/29/2020,724,39,105384,284138,40708,7331986,219,126840,3749,262,,,,,-45,-14,22,-50,-49,17,71.3,12.561111,10.416667,14.844444,10.456333,10.17284,82.432553
6/30/2020,623,47,144787,284761,40755,7486285,296,127136,3384,279,,,,,-45,-12,34,-50,-48,17,71.3,13.016667,11.027778,15.161111,4.233333,10.117284,79.452827
7/1/2020,652,26,157131,285413,40781,7643831,270,127406,3199,259,,,,,-47,-13,34,-49,-48,17,71.3,12.405556,9.961111,16.494444,1.415143,11.061728,88.630318
7/2/2020,606,43,169259,286019,40824,7812218,216,127622,3080,239,,,,,-47,-11,39,-49,-48,17,71.3,11.094444,8.583333,13.805556,4.172857,9.265432,85.517688
7/3/2020,568,30,172566,286587,40854,7985271,214,127836,2943,231,,,,,-49,-12,20,-49,-47,18,71.3,13.2,10.138889,15.827778,1.705429,11.82716,88.561658
7/4/2020,399,33,126100,286986,40887,8111677,202,128038,2803,221,,,,,-51,-15,13,-41,-18,8,69.91,15.105556,13.266667,17.194444,8.418286,13.512346,87.527242
7/5/2020,558,28,97315,287544,40915,8210372,195,128233,2742,217,,,,,-48,-18,53,-37,-14,6,69.91,12.888889,9.705556,15.555556,4.281714,9.32716,75.996643
7/6/2020,714,37,94284,288258,40952,8305032,203,128436,2700,209,,,,,-36,-11,76,-43,-48,14,64.35,12.838889,9.261111,16.827778,4.543778,7.839506,68.618258
7/7/2020,609,27,126238,288867,40979,8431626,215,128651,2599,197,,,,,-40,-12,52,-45,-48,16,64.35,11.244444,8.122222,13.716667,0,8.296296,78.915003
7/8/2020,713,24,153092,289580,41003,8584627,207,128858,2455,185,,,,,-42,-14,29,-47,-47,16,64.35,11.961111,8.611111,15.594444,0.290286,9.083333,82.788167
7/9/2020,722,37,161796,290302,41040,8746603,214,129072,2346,188,,,,,-42,-12,38,-46,-47,16,64.35,11.583333,8.994444,14.244444,6.930571,8.911111,83.850809
7/10/2020,568,23,154864,290870,41063,8901570,175,129247,2245,191,,,,,-41,-10,67,-40,-46,14,64.35,11.638889,8.25,15.016667,5.152571,8.883333,83.339998
7/11/2020,459,21,134890,291329,41084,9036673,177,129424,2120,168,,,,,-47,-12,69,-32,-14,6,64.35,12.155556,7.455556,15.838889,2.3114,7.45,73.609644
7/12/2020,366,14,101927,291695,41098,9139226,114,129538,2102,159,,,,,-43,-15,103,-27,-10,3,64.35,13.133333,5.9,18.094444,0.0254,7.844444,70.676601
7/13/2020,740,26,97403,292435,41124,9235686,189,129727,2114,162,,,,,-35,-11,71,-42,-48,14,64.35,14.461111,10.794444,17.605556,0.544286,11.522222,82.946487
7/14/2020,705,21,132121,293140,41145,9368703,186,129913,1994,145,,,,,-36,-11,73,-43,-48,15,64.35,12.683333,8.211111,16.294444,0.931333,8.944444,78.601761
7/15/2020,777,20,152063,293917,41165,9524251,168,130081,1975,153,,,,,-33,-13,52,-47,-46,15,64.35,13.294444,10.855556,15.183333,0.725714,11.25,87.746858
7/16/2020,712,13,165966,294629,41178,9690514,166,130247,1830,142,,,,,-31,-10,85,-45,-45,14,64.35,15.994444,12.144444,20.116667,0.508,13.080247,79.887656
7/17/2020,582,18,177625,295211,41196,9868579,143,130390,1805,143,,,,,-33,-10,93,-41,-44,13,64.35,15.711111,12.455556,17.922222,0.169333,13.574074,84.493029
7/18/2020,505,15,140393,295716,41211,10009148,105,130495,1777,137,,,,,-40,-13,61,-35,-14,5,64.35,15.216667,10.494444,17.488889,5.842,11.938889,81.091848
7/19/2020,448,14,120968,296164,41225,10130116,126,130621,1743,131,,,,,-35,-16,78,-32,-10,3,64.35,12.172222,6.561111,16.6,0.9398,6.666667,69.691845
7/20/2020,830,12,101741,296994,41237,10232901,130,130751,1735,129,,,,,-25,-9,114,-42,-48,13,64.35,11.777778,6.294444,15.788889,0,7.172222,73.979225
7/21/2020,788,21,142559,297782,41258,10375459,125,130876,1635,137,,,,,-28,-10,116,-43,-48,13,64.35,12.594444,6.744444,17.266667,0.056444,7.172222,69.886787
7/22/2020,816,18,147595,298598,41276,10523054,158,131034,1748,110,,,,,-29,-11,89,-44,-46,14,64.35,13.427778,10.238889,15.7,0.254,10.855556,84.746311
7/23/2020,808,16,152133,299406,41292,10675176,198,131232,1539,111,,,,,-30,-9,81,-45,-47,14,64.35,14.611111,12.088889,17.627778,6.386286,13.088889,90.748512
7/24/2020,774,7,157229,300180,41299,10832984,159,131391,1454,104,,,,,-32,-12,95,-40,-46,13,64.35,14.888889,9.883333,18.616667,5.3975,10.983333,77.737778
7/25/2020,530,17,142954,300710,41316,10975936,120,131511,1402,93,,,,,-40,-16,25,-37,-15,6,64.35,15.811111,12.888889,18.577778,1.80975,13.259259,81.892786
7/26/2020,563,17,113424,301273,41333,11095717,109,131620,1384,92,,,,,-33,-17,78,-30,-9,3,64.35,14.344444,10.988889,17.05,1.17475,11.185185,78.429151
7/27/2020,869,13,99090,302142,41346,11195038,129,131749,1371,97,,,,,-29,-14,40,-46,-51,14,64.35,13.561111,11.294444,17.222222,4.064,11.919753,86.935062
7/28/2020,856,12,154946,302998,41358,11349983,119,131868,1370,93,,,,,-26,-10,100,-42,-48,14,64.35,12.572222,9.866667,15.388889,7.112,7.987654,70.485135
7/29/2020,1062,12,165480,304060,41370,11515652,131,131999,1351,87,,,,,-25,-10,107,-41,-48,13,64.35,12.633333,9.005556,16.183333,0.0762,7.255556,70.562665
7/30/2020,946,10,206656,305006,41380,11722733,132,132131,1315,84,,,,,-23,-7,120,-41,-48,13,64.35,14.422222,8.733333,20.077778,1.016,11.905556,84.986762
7/31/2020,698,14,190220,305704,41394,11912950,114,132245,1267,86,,,,,-29,-11,120,-37,-48,11,64.35,20.783333,11.827778,29.255556,2.322286,13.455556,63.118468
8/1/2020,559,11,162088,306263,41405,12075267,128,132373,1291,92,,,,,-36,-14,72,-30,-14,4,69.91,15.983333,12.238889,19.027778,0.381,12.238889,78.96834
8/2/2020,564,10,163786,306827,41415,12250937,93,132466,1255,85,,,,,-28,-15,93,-27,-9,2,69.91,13.766667,10.383333,17.055556,2.322286,9.983333,78.482091
8/3/2020,1060,16,158666,307887,41431,12407146,110,132576,1253,77,,,,,-15,-11,115,-39,-49,11,69.91,12.511111,7.444444,16.316667,0.9398,7.438889,71.774038
8/4/2020,1066,14,163422,308953,41445,12571991,125,132701,1218,76,,,,,-19,-13,89,-42,-49,13,69.91,12.4,6.577778,16.683333,0.870857,10.605556,88.965115
8/5/2020,1092,6,174519,310045,41451,12748043,138,132839,1202,73,,,,,-16,-13,86,-43,-48,13,69.91,17.3,15.316667,19.544444,7.4295,15.092593,84.319876
8/6/2020,1105,9,185980,311150,41460,12938980,100,132939,1157,69,,,,,-23,-10,120,-42,-48,12,69.91,17.688889,13.016667,21.233333,2.0828,14.422222,81.623841
8/7/2020,973,13,181864,312123,41473,13121091,117,133056,1096,67,,,,,-28,-12,114,-39,-48,11,69.91,19.083333,12.933333,23.85,0,15.783333,81.652053
8/8/2020,710,14,165176,312833,41487,13286362,139,133195,1028,62,,,,,-35,-14,92,-31,-13,3,69.91,15.616667,10.844444,19.85,0,11.355556,75.8492
8/9/2020,627,9,166207,313460,41496,13453361,106,133301,984,65,,,,,-28,-15,103,-27,-8,1,69.91,15.055556,11.3,18.877778,0,11.666667,80.411591
8/10/2020,1499,13,164061,314959,41509,13618470,86,133387,1089,70,,,,,-11,-11,118,-40,-48,11,69.91,17.261111,12.988889,22.644444,0,13.922222,80.867574
8/11/2020,1378,10,166311,316337,41519,13785297,113,133500,1040,73,,,,,-13,-11,118,-41,-48,12,69.91,19.561111,14.088889,25.488889,3.781778,16.077778,80.686319
8/12/2020,1242,8,184444,317579,41527,13971512,101,133601,1006,80,,,,,-14,-11,100,-42,-47,12,69.91,20.072222,15.577778,25.572222,0.0508,16.538889,80.180662
8/13/2020,1156,9,169857,318735,41536,14142736,129,133730,1010,75,,,,,-24,-10,89,-43,-48,13,66.2,15.822222,13.955556,17.922222,0.465667,14.455556,91.747051
8/14/2020,1185,7,177957,319920,41543,14320621,100,133830,997,73,,,,,-26,-12,76,-39,-46,12,66.2,14.838889,13.094444,17.255556,3.344333,13.633333,92.565435
8/15/2020,714,13,182987,320634,41556,14503645,99,133929,976,76,,,,,-33,-15,50,-33,-13,4,66.2,15,12.377778,17.805556,0.3048,12.711111,86.585111
8/16/2020,602,4,169276,321236,41560,14674841,80,134009,981,78,,,,,-29,-18,52,-32,-10,3,66.2,13.733333,12.572222,15.161111,2.4765,12.494444,92.352375
8/17/2020,1298,12,150174,322534,41572,14825051,95,134104,984,73,,,,,-9,-14,80,-41,-48,11,66.2,15.527778,12.75,19.638889,9.760857,13.655556,88.773374
8/18/2020,1116,9,163010,323650,41581,14988134,128,134232,955,73,,,,,-11,-13,93,-41,-46,12,66.2,15.294444,12.538889,17.827778,3.519714,13.838889,91.217118
8/19/2020,1282,4,190434,324932,41585,15177265,113,134345,926,70,,,,,-15,-17,39,-44,-46,13,66.2,16.694444,11.8,20.477778,4.100286,14.738889,88.386135
8/20/2020,1498,8,183933,326430,41593,15363416,97,134442,910,76,,,,,-19,-10,121,-40,-46,11,66.2,17.694444,13.233333,21.033333,6.31825,11.633333,68.273381
8/21/2020,1218,7,191360,327648,41600,15554879,109,134551,889,72,,,,,-26,-13,56,-40,-45,12,66.2,15.666667,13.083333,17.905556,1.197429,12.316667,80.874203
8/22/2020,842,9,181455,328490,41609,15736334,72,134623,944,71,,,,,-31,-15,53,-32,-11,4,66.2,14.372222,11.572222,17.305556,9.906,12.104938,83.409812
8/23/2020,831,16,175209,329321,41625,15912155,74,134697,871,72,,,,,-26,-17,64,-29,-7,2,66.2,13.488889,9.577778,16.433333,5.116286,11.944444,87.803597
8/24/2020,1301,6,153393,330622,41631,16065561,91,134788,877,68,,,,,-3,-12,105,-38,-46,10,66.2,12.383333,8.394444,16.505556,9.42975,8.6,78.320082
8/25/2020,1270,13,186500,331892,41644,16273209,119,134907,846,68,,,,,-13,-16,31,-45,-47,13,66.2,13.777778,9.394444,17.444444,2.431143,12.711111,93.313844
8/26/2020,1388,11,208835,333280,41655,16483449,130,135037,831,64,,,,,-3,-11,90,-38,-44,11,66.2,12.866667,10.338889,15.194444,20.755429,11.123457,86.49667
8/27/2020,1591,9,203416,334871,41664,16698964,152,135189,842,71,,,,,-21,-12,55,-42,-45,12,66.2,12.127778,8.861111,15.438889,2.431143,11.259259,92.051062
8/28/2020,1632,11,197211,336503,41675,16896834,137,135326,819,60,,,,,-20,-9,51,-37,-45,11,66.2,11.111111,9.383333,13.25,14.768286,9.382716,85.765162
8/29/2020,1230,5,183510,337733,41680,17080344,110,135436,834,66,,,,,-27,-13,49,-29,-12,3,66.2,9.688889,6.733333,12.05,2.830286,6.685185,78.364111
8/30/2020,1171,6,182065,338904,41686,17262409,77,135513,832,68,,,,,-15,-14,94,-23,-7,1,66.2,9.9,4.688889,13.572222,0.127,5.938272,73.760415
8/31/2020,1513,10,181934,340417,41696,17444343,90,135603,855,71,,,,,3,-17,152,-43,-68,14,66.2,10.372222,3.755556,16.144444,0,5.283333,70.89805
9/1/2020,2288,5,175687,342705,41701,17619897,134,135737,863,82,,,,,-15,-6,94,-37,-44,10,64.35,11.766667,4.411111,17.572222,0,7.127778,73.400996
9/2/2020,3077,11,203221,345782,41712,17823349,145,135882,805,81,,,,,-20,-11,48,-41,-42,11,64.35,12.738889,8.083333,16.794444,3.048,10.488889,86.379553
9/3/2020,3152,10,206883,348934,41722,18031292,146,136028,819,76,,,,,-20,-10,58,-40,-42,11,64.35,14.938889,12.183333,17.488889,9.11225,11.766667,81.808722
9/4/2020,3092,9,210463,352026,41731,18240704,154,136182,820,69,,,,,-21,-10,61,-35,-40,9,64.35,12.216667,8.838889,15.088889,0.3175,8.627778,79.254073
9/5/2020,2551,13,191588,354577,41744,18432292,130,136312,814,67,,,,,-26,-12,56,-30,-10,3,64.35,11.283333,8.427778,14.427778,1.74625,7.9,80.252325
9/6/2020,2465,9,189974,357042,41753,18625666,137,136449,819,69,,,,,-21,-12,69,-27,-7,2,64.35,11.655556,8.911111,14.566667,1.451429,9.588889,87.242926
9/7/2020,3931,15,195692,360973,41768,18823212,145,136594,904,77,,,,,-17,-10,58,-36,-43,9,64.35,13.594444,8.922222,16.733333,2.975429,12.555556,90.882189
9/8/2020,3370,10,209609,364343,41778,19060505,184,136778,896,80,,,,,-19,-10,74,-35,-42,9,64.35,17.205556,14.9,19.555556,2.850444,15.376543,86.380832
9/9/2020,3365,10,227465,367708,41788,19293329,203,136981,926,80,,,,,-20,-11,67,-36,-39,9,64.35,13.627778,7.605556,17.333333,0.903111,9.265432,72.178266
9/10/2020,3628,13,240312,371336,41801,19542389,217,137198,946,78,,,,,-20,-9,78,-36,-40,9,64.35,9.5,4.044444,13.133333,0,5.966667,79.11644
9/11/2020,3324,13,250839,374660,41814,19832981,230,137428,772,143,,,,,-22,-9,62,-32,-38,8,64.35,12.605556,9.622222,15.327778,0.3048,9.488889,81.819899
9/12/2020,2670,18,231969,377330,41832,20064950,217,137645,814,86,,,,,-27,-11,61,-28,-9,3,64.35,12.594444,8.733333,15.377778,2.8448,8.322222,75.800019
9/13/2020,2154,17,227075,379484,41849,20292025,227,137872,845,92,,,,,-21,-12,94,-24,-7,1,64.35,15.888889,11.961111,18.85,0.9906,12.654321,78.466477
9/14/2020,3428,21,221192,382912,41870,20521243,257,138129,984,105,,,,,-17,-9,104,-32,-36,8,65.74,16.1,10.061111,22.272222,0.0508,12.316667,78.462401
9/15/2020,3551,18,288822,386463,41888,20811196,268,138397,1068,115,,,,,-19,-9,91,-34,-36,9,65.74,17.811111,10.488889,24.555556,0,12.994444,73.592594
9/16/2020,4399,27,285296,390862,41915,21099610,281,138678,1108,124,,,,,-21,-11,71,-35,-36,9,65.74,12.388889,9.394444,15.322222,0.0508,10.261111,86.95806
9/17/2020,4675,28,267294,395537,41943,21368297,264,138942,1164,127,,,,,-20,-9,88,-35,-36,9,65.74,11.866667,6.011111,17.444444,0,7.505556,74.737914
9/18/2020,4973,24,289911,400510,41967,21659184,262,139204,1223,138,,,,,-22,-9,75,-32,-35,8,65.74,10.533333,4.355556,15.727778,0.0254,7.127778,79.596447
9/19/2020,4889,21,265697,405399,41988,21924881,261,139465,1302,144,,,,,-27,-11,67,-29,-10,3,65.74,11.716667,8.05,15.45,0,8.216667,79.347422
9/20/2020,5340,32,247099,410739,42020,22171979,288,139753,1400,165,,,,,-22,-12,85,-26,-7,2,65.74,12.033333,8.45,15.094444,0.423333,9.427778,84.494591
9/21/2020,5627,27,219677,416366,42047,22393731,371,140124,1560,181,,,,,-17,-8,86,-34,-37,8,65.74,12.027778,5.166667,18.355556,0.028222,8.838889,81.160463
9/22/2020,6441,40,247083,422807,42087,22621213,350,140474,1638,211,,,,,-22,-9,64,-36,-36,9,65.74,13.372222,9.038889,17.677778,0.0635,11.524691,85.974464
9/23/2020,7096,58,269276,429903,42145,22905284,422,140896,1732,228,,,,,-27,-11,20,-40,-35,11,65.74,9.427778,6.916667,12.794444,4.572,8.566667,94.406143
9/24/2020,7682,35,274435,437585,42180,23192768,423,141319,1848,243,,,,,-26,-9,28,-41,-35,11,67.59,6.466667,2.183333,9.394444,9.688286,5.592593,91.215706
9/25/2020,7318,33,298023,444903,42213,23492213,382,141701,2022,262,,,,,-25,-7,29,-37,-34,10,67.59,7.888889,4.844444,11.416667,5.479143,4.288889,78.523178
9/26/2020,6810,40,259782,451713,42253,23751995,351,142052,2035,261,,,,,-28,-10,28,-34,-9,5,67.59,7.427778,3.6,10.944444,0.635,3.333333,75.673989
9/27/2020,7023,49,267096,458736,42302,24019091,342,142394,2190,276,,,,,-25,-13,45,-32,-7,3,67.59,7.811111,3.344444,11.416667,0,4.088889,77.349947
9/28/2020,9983,54,233827,468719,42356,24253396,444,142838,2401,297,,,,,-19,-8,45,-38,-35,10,67.59,8.544444,1.227778,14.261111,0.381,6.522222,87.248276
9/29/2020,10366,48,238875,479085,42404,24512866,440,143278,2422,314,,,,,-22,-8,47,-38,-34,10,67.59,9.411111,4.044444,14.583333,0.3048,6.155556,80.428575
9/30/2020,12717,57,260572,491802,42461,24776365,450,143728,2531,333,,,,,-26,-11,4,-40,-34,11,67.59,10.133333,6.738889,12.066667,0.943429,8.805556,91.591326
10/1/2020,13357,67,271880,505159,42528,25053421,528,144256,2593,341,,,,,-23,-6,36,-39,-32,10,67.59,8.038889,2.894444,12.155556,6.321778,5.233333,82.803947
10/2/2020,13854,70,276327,519013,42598,25330030,532,144788,2725,369,,,,,-30,-10,4,-37,-32,11,67.59,7.894444,0.861111,12.75,0.22225,6.455556,90.750396
10/3/2020,11667,67,287478,530680,42665,25617508,535,145323,2868,369,,,,,-34,-12,-20,-40,-12,7,67.59,10.766667,9.594444,11.922222,1.306286,10.316667,97.078599
10/4/2020,11953,60,251828,542633,42725,25869336,633,145956,3057,369,,,,,-31,-15,-4,-38,-9,5,67.59,11.116667,8.55,13.827778,31.641143,9.422222,89.436005
10/5/2020,16753,72,279549,559386,42797,26153569,631,146587,3371,393,,,,,-24,-10,23,-37,-34,10,67.59,10.888889,8.85,13.416667,1.778,8.777778,87.118326
10/6/2020,17250,71,266406,576636,42868,26425017,725,147312,3643,410,,,,,-26,-9,20,-38,-34,10,67.59,10.45,7.255556,13.377778,0.846667,7.933333,84.720475
10/7/2020,18573,102,258256,595209,42970,26684760,692,148004,3894,442,,,,,-24,-9,31,-38,-32,10,67.59,10.044444,7.383333,12.466667,0.399143,6.727778,80.331951
10/8/2020,18425,95,289512,613634,43065,26992618,714,148718,4085,436,,,,,-27,-9,21,-41,-33,11,67.59,8.094444,4.266667,11.844444,10.559143,5.505556,83.945796
10/9/2020,15893,80,302228,629527,43145,27294846,708,149426,4170,440,,,,,-28,-8,19,-37,-31,10,67.59,7.183333,3.894444,9.605556,1.778,4.233333,81.9453
10/10/2020,12648,105,280996,642175,43250,27575841,723,150149,4358,469,,,,,-31,-10,14,-37,-8,6,67.59,8.077778,3.788889,11.244444,2.322286,5.983333,86.866235
10/11/2020,12202,125,258965,654377,43375,27834806,825,150974,4670,477,,,,,-27,-13,49,-33,-6,4,67.59,7.911111,4.794444,10.883333,1.1176,5.033333,82.323436
10/12/2020,19671,114,224545,674048,43489,28061484,888,151862,4959,507,,,,,-27,-12,9,-40,-35,11,60.19,8.016667,5.483333,10.316667,0.435429,6.961111,93.136807
10/13/2020,19116,111,270433,693164,43600,28378932,1029,152891,5293,516,,,,,-29,-11,14,-41,-35,11,60.19,7.366667,2.322222,9.988889,4.318,6.45,93.950961
10/14/2020,19920,117,298700,713084,43717,28683607,983,153874,5598,563,,,,,-27,-9,23,-40,-33,11,60.19,9.144444,5.588889,12.055556,4.971143,8.092593,90.240996
10/15/2020,18607,151,308726,731691,43868,28992751,1044,154918,5933,581,,,,,-27,-7,29,-40,-33,11,60.19,6.888889,3.683333,9.916667,1.415143,5.166667,85.92796
10/16/2020,17915,150,317642,749606,44018,29310390,925,155843,6297,592,,,,,-27,-6,25,-37,-32,11,60.19,7.3,4.311111,10.122222,0.254,5.796296,87.201516
10/17/2020,14882,179,308094,764488,44197,29618484,1031,156874,6546,614,,,,,-33,-9,18,-40,-10,7,60.19,8.377778,5.933333,10.988889,0.181429,7.617284,91.790922
10/18/2020,14311,161,306947,778799,44358,29925431,1092,157966,6831,630,,,,,-30,-13,36,-38,-9,5,60.19,7,4.072222,8.922222,0.338667,5.833333,89.357344
10/19/2020,25872,192,266052,804671,44550,30193733,1106,159072,7337,658,,,,,-26,-10,27,-41,-35,11,65.74,9.244444,7.194444,11.388889,0.5715,7.395062,85.351205
10/20/2020,25613,200,285682,830284,44750,30490795,1191,160263,7855,698,,,,,-28,-9,28,-41,-35,12,65.74,11.611111,8.161111,15.683333,3.084286,9.3,85.893613
10/21/2020,25714,221,315196,855998,44971,30816131,1265,161528,8135,712,,,,,-31,-11,-2,-44,-35,13,65.74,11.766667,9.216667,13.716667,1.524,10.533333,92.239448
10/22/2020,23475,236,344122,879473,45207,31165166,1283,162811,8314,708,,,,,-26,-6,34,-42,-34,12,67.59,8.938889,5.394444,11.477778,2.032,6.872222,87.230251
10/23/2020,21694,224,350370,901167,45431,31515972,1299,164110,8889,744,,,,,-28,-6,19,-41,-35,12,75,6.488889,3.911111,9.727778,0.907143,4.305556,86.100449
10/24/2020,16434,214,318112,917601,45645,31834084,1261,165371,9264,788,,,,,-38,-12,-10,-44,-13,8,75,7.688889,4.377778,11.066667,3.229429,6.077778,89.671552
10/25/2020,15896,252,321711,933497,45897,32155795,1425,166796,9788,828,,,,,-29,-10,32,-39,-10,5,75,7.077778,4.655556,10.144444,5.3848,4.527778,84.130707
10/26/2020,26807,283,267189,960304,46180,32425481,1541,168337,10110,853,,,,,-21,-9,42,-44,-45,13,75,7.561111,4.888889,10.066667,4.826,5.483333,86.915121
10/27/2020,24350,269,312873,984654,46449,32755061,1497,169834,10939,903,,,,,-27,-10,10,-47,-45,14,75,6.966667,4.666667,9.005556,3.410857,5.416667,90.022352
10/28/2020,23901,287,344290,1008555,46736,33099491,1494,171328,11437,957,,,,,-23,-8,27,-45,-43,14,75,6.833333,4.588889,9.205556,5.116286,4.355556,84.532788
10/29/2020,23614,314,377709,1032169,47050,33479500,1589,172917,11586,974,,,,,-27,-9,4,-48,-44,15,75,9.25,4.966667,13.094444,4.426857,7.644444,89.76309
10/30/2020,22890,340,329543,1055059,47390,33812687,1383,174300,11790,979,,,,,-26,-5,25,-43,-42,13,75,9.877778,2.694444,13.622222,7.547429,8.222222,86.639894
10/31/2020,16673,326,305889,1071732,47716,34121466,1460,175760,12312,1003,,,,,-38,-9,-15,-44,-13,8,75,9.761111,2.944444,13.35,2.286,7.561728,83.523627
11/1/2020,15970,361,281609,1087702,48077,34404990,1497,177257,12232,979,,,,,-29,-13,-4,-40,-10,5,75,9.916667,6.811111,14.555556,4.789714,7.932099,84.684478
11/2/2020,31925,343,221799,1119627,48420,34641799,1574,178831,13107,1075,,,,,-17,-7,8,-40,-34,11,75,8.166667,5.827778,12.105556,18.142857,6.734568,87.33618
11/3/2020,25943,363,277066,1145570,48783,34930006,1522,180353,13750,1144,,,,,-17,-6,6,-39,-33,11,75,4.811111,1.605556,6.916667,6.63575,2.660494,83.245765
11/4/2020,24027,329,309000,1169597,49112,35251116,1687,182040,13818,1193,,,,,-11,-4,19,-36,-31,10,75,5.083333,0.855556,9.566667,0.5588,3.148148,85.375992
11/5/2020,24062,383,356376,1193659,49495,35611108,1590,183630,13796,1183,,,,,-54,-14,8,-52,-38,16,75,7.777778,4.016667,10.972222,0.056444,6.549383,90.487361
11/6/2020,23660,402,362436,1217319,49897,35973636,1416,185046,13958,1187,,,,,-55,-12,5,-52,-38,17,72.22,6.288889,2.9,9.633333,0.028222,4.572222,89.577005
11/7/2020,18766,395,330639,1236085,50292,36304554,1559,186605,14314,1207,,,,,-60,-16,13,-58,-28,13,72.22,6.144444,2.561111,8.988889,0.056444,3.833333,86.814577
11/8/2020,20245,419,284742,1256330,50711,36592352,1692,188297,14546,1232,,,,,-60,-20,5,-57,-28,10,72.22,8.738889,5.461111,10.794444,0.3175,8.037037,94.487639
11/9/2020,31511,487,253031,1287841,51198,36846231,1766,190063,15141,1271,,,,,-47,-15,5,-50,-39,15,66.67,10.538889,9.072222,12.355556,0.635,9.838889,95.488222
11/10/2020,27789,392,310996,1315630,51590,37156950,1855,191918,14964,1219,,,,,-48,-13,14,-49,-39,15,64.81,10.677778,8.377778,12.294444,0.6858,9.6,93.138519
11/11/2020,27757,392,381759,1343387,51982,37543614,1973,193891,15665,1268,,,,,-49,-14,-1,-51,-38,16,64.81,9.4,7.094444,10.966667,0.127,8.148148,89.1761
11/12/2020,24826,423,382551,1368213,52405,37927033,1918,195809,15878,1275,,,,,-48,-10,19,-50,-39,16,64.81,8.916667,7.322222,10.555556,3.52425,6.54321,82.111808
11/13/2020,24389,439,385312,1392602,52844,38312459,1651,197460,16234,1355,,,,,-49,-8,7,-50,-38,16,64.81,7.755556,5.133333,10.022222,1.016,5.172222,84.028719
11/14/2020,18223,438,342578,1410825,53282,38655144,1616,199076,16297,1365,,,,,-59,-16,-29,-59,-28,13,64.81,8.691358,4.876543,12.345679,3.592286,7.75,91.062191
11/15/2020,16232,458,284592,1427057,53740,38938447,1673,200749,16862,1397,,,,,-57,-19,-5,-57,-28,10,64.81,8.006173,5.549383,9.716049,3.773714,5.888889,86.772278
11/16/2020,26951,425,239933,1454008,54165,39197362,1771,202520,17311,1391,,,,,-46,-14,2,-50,-39,15,64.81,8.822222,6.333333,11.011111,7.14375,6.487654,82.500696
11/17/2020,23487,444,288783,1477495,54609,39491325,1718,204238,17436,1420,,,,,-48,-12,6,-50,-39,15,64.81,12.583333,9.2,13.844444,2.866571,10.882716,86.646498
11/18/2020,21080,493,367219,1498575,55102,39868912,1785,206023,17483,1430,,,,,-49,-13,-7,-51,-38,16,64.81,9.916667,6.077778,13.861111,0.580571,7.266667,83.998165
11/19/2020,18041,466,397852,1516616,55568,40274972,1687,207710,17457,1426,,,,,-48,-10,6,-51,-39,16,64.81,3.683333,-0.433333,7.172222,6.575778,0.177778,78.320366
11/20/2020,17100,457,397835,1533716,56025,40672888,1550,209260,17183,1422,,,,,-50,-8,-17,-51,-38,17,67.59,5.822222,-0.6,10.755556,0.072571,4.622222,92.11209
11/21/2020,12533,470,365104,1546249,56495,41038806,1462,210722,17062,1447,,,,,-56,-12,-8,-56,-26,12,67.59,8.716049,5.376543,10.771605,3.664857,6.41358,85.883031
11/22/2020,11895,479,278653,1558144,56974,41321913,1492,212214,17263,1454,,,,,-53,-15,25,-53,-26,9,67.59,4.888889,2.672222,7.338889,1.778,2.055556,82.304108
11/23/2020,19024,465,218594,1577168,57439,41542416,1590,213804,17680,1487,,,,,-44,-12,4,-50,-39,15,67.59,5.666667,1.583333,9.983333,0.0762,3.972222,89.016322
11/24/2020,16677,465,316284,1593845,57904,41869040,1499,215303,17424,1489,,,,,-47,-10,3,-50,-38,15,67.59,9.6,8.111111,10.7,5.116286,7.648148,85.081408
11/25/2020,16813,488,359487,1610658,58392,42227353,1613,216916,17132,1480,,,,,-47,-12,-5,-51,-37,16,67.59,5.394444,1.705556,8.855556,2.667,3.977778,90.742058
11/26/2020,14761,435,385980,1625419,58827,42614085,1423,218339,16762,1456,,,,,-46,-9,10,-51,-37,15,67.59,4.8,1.816667,6.866667,0.1016,3.611111,89.527924
11/27/2020,14555,430,336982,1639974,59257,42951337,1280,219619,16572,1417,,,,,-47,-7,-2,-50,-38,16,67.59,3.622222,0.6,5.466667,0,1.633333,87.048392
11/28/2020,11086,471,311293,1651060,59728,43262819,1221,220840,15986,1378,,,,,-55,-12,-11,-55,-24,12,67.59,1.777778,-2.783333,5.538889,0.169333,0.866667,93.821198
11/29/2020,10851,466,219845,1661911,60194,43486293,1390,222230,16314,1387,,,,,-53,-15,5,-54,-24,9,67.59,6.577778,4.366667,7.444444,0.616857,6.444444,96.828945
11/30/2020,18197,426,220041,1680108,60620,43740383,1406,223636,16566,1357,,,,,-41,-9,-9,-49,-37,14,67.59,6.611111,2.761111,9.816667,0.362857,4.272222,85.24572
12/1/2020,16684,400,316377,1696792,61020,44072109,1491,225127,16313,1351,,,,,-43,-7,7,-48,-36,14,67.59,2.527778,-1.188889,5.338889,0.9144,0.5,86.760843
12/2/2020,16676,387,356146,1713468,61407,44428306,1487,226614,15978,1315,,,,,-31,-6,-7,-45,-32,13,67.59,4.444444,1.333333,7.361111,0.141111,2.711111,88.708142
12/3/2020,15860,477,391527,1729328,61884,44822336,1500,228114,15659,1261,,,,,-34,-8,-20,-46,-33,14,63.89,2.388889,1.127778,3.172222,3.048,1.577778,94.459109
12/4/2020,15834,477,385035,1745162,62361,45207446,1431,229545,15728,1274,,,,,-35,-5,-18,-44,-33,14,63.89,2.683333,0.611111,5.044444,6.096,1.838889,94.246602
12/5/2020,12893,396,354378,1758055,62757,45561867,1379,230924,15689,1247,,,,,-36,-6,-8,-41,-13,8,63.89,2.709877,-0.12963,4.993827,10.014857,1.444444,91.539556
12/6/2020,13731,422,271825,1771786,63179,45833736,1471,232395,15961,1249,,,,,-36,-10,1,-41,-13,7,63.89,3.506173,0.45679,5.197531,2.503714,3.018519,96.648587
12/7/2020,21585,426,222150,1793371,63605,46058315,1661,234056,16416,1271,,,,,-26,-5,-4,-43,-34,12,63.89,2.416667,0.477778,4.238889,0.98425,1.511111,93.87836
12/8/2020,21065,436,299485,1814436,64041,46358046,1782,235838,16478,1272,,,,,-31,-5,-7,-44,-33,12,67.59,3.611111,0.988889,5.066667,0.544286,2.67284,93.563713
12/9/2020,21909,433,372160,1836345,64474,46744056,1756,237594,16332,1243,,,,,-31,-5,-5,-44,-32,13,67.59,3.805556,1.816667,5.088889,2.2225,3.216667,96.021897
12/10/2020,22916,450,402838,1859261,64924,47153003,1752,239346,16724,1267,,,,,-32,-3,-1,-44,-33,13,67.59,3.9,1.966667,5.038889,0.870857,3.011111,94.034415
12/11/2020,24390,455,394645,1883651,65379,47547749,1690,241036,16886,1275,,,,,-33,-2,-5,-41,-32,13,67.59,5.727778,4.438889,6.6,3.918857,5.574074,96.337294
12/12/2020,19588,441,356335,1903239,65820,47904103,1798,242834,16910,1243,,,,,-37,-5,-5,-39,-12,8,67.59,5.746914,4.024691,6.641975,1.959429,5.271605,96.793768
12/13/2020,22266,421,311966,1925505,66241,48216087,1755,244589,17538,1281,,,,,-41,-13,-31,-45,-14,8,67.59,5.006173,1.364198,8.253086,1.560286,4.290123,95.166526
12/14/2020,35197,482,281738,1960702,66723,48498962,1954,246543,18245,1288,,,,,-25,-2,2,-42,-35,12,73.15,7.344444,5.377778,9.077778,7.676444,5.55,88.593363
12/15/2020,34378,462,309012,1995080,67185,48823017,1959,248502,18215,1326,,,,,-25,0,10,-41,-34,12,73.15,5.338889,3.461111,7.122222,2.3368,4.197531,89.914133
12/16/2020,35427,432,367880,2030507,67617,49190968,2077,250579,18669,1340,,,,,-33,-3,-14,-46,-34,14,73.15,6.355556,4.138889,8.016667,0.870857,5.094444,91.743299
12/17/2020,34438,539,376904,2064945,68156,49590278,2143,252722,18969,1366,,,,,-29,2,12,-44,-35,13,73.15,6.272222,3.538889,8.733333,8.1915,4.8,90.487791
12/18/2020,36419,517,395461,2101364,68673,49986713,1923,254645,19116,1364,,,,,-33,-1,-14,-45,-37,15,73.15,10.855556,7.827778,12.066667,6.495143,9.746914,90.308933
12/19/2020,25590,491,437697,2126954,69164,50424552,2044,256689,19462,1412,,,,,-40,-3,-10,-41,-13,8,76.85,7.703704,4.716049,11.074074,7.874,5.814815,88.027179
12/20/2020,33066,506,433595,2160020,69670,50858246,2169,258858,20004,1442,,,,,-43,-7,5,-45,-13,7,76.85,5.105556,3.033333,6.727778,4.85775,3.3,88.339021
12/21/2020,48192,577,431417,2208212,70247,51299623,2370,261228,21133,1512,,,,,-26,12,-8,-52,-49,16,76.85,4.75,2.394444,6.005556,2.3495,3.944444,94.586282
12/22/2020,46475,564,457086,2254687,70811,51760217,2481,263709,21489,1529,,,,,-26,17,14,-52,-50,16,76.85,2.422222,-0.488889,5.466667,1.890889,1.222222,91.895224
12/23/2020,42936,567,511489,2297623,71378,52271556,2277,265986,21222,1554,,,,,-27,23,-12,-54,-53,18,76.85,3.433333,0.633333,4.75,0.834571,2.35,92.723609
12/24/2020,32392,586,461773,2330015,71964,52733758,2086,268072,21577,1607,,,,,-35,14,19,-59,-65,21,79.63,0.450617,-1.419753,2.438272,6.894286,-1.722222,85.54355
12/25/2020,14419,616,337502,2344434,72580,53071475,2184,270256,20918,1616,,,,,-92,-89,-25,-85,-85,27,75.46,0.5,-3.438272,5.006173,1.665111,-1.487654,86.841685
12/26/2020,41110,659,271205,2385544,73239,53343226,2531,272787,21730,1682,,,,,-81,-63,-34,-76,-54,15,79.63,5.740741,2.333333,6.746914,0.943429,4.0625,85.532939
12/27/2020,48520,662,354234,2434064,73901,53766231,2871,275658,22764,1751,,,,,-58,-24,3,-59,-29,10,79.63,2.35,0.488889,6.011111,19.521714,0.661111,88.858005
12/28/2020,46409,682,361413,2480473,74583,54128440,3131,278789,24050,1847,,,,,-51,-24,16,-70,-77,26,79.63,-0.361111,-2.433333,1.244444,1.2192,-1.094444,94.855958
12/29/2020,83090,659,350266,2563563,75242,54480154,3250,282039,25550,1939,,,,,-47,-11,14,-64,-68,24,79.63,0.483333,-2.033333,2.766667,0.254,-0.322222,94.427624
12/30/2020,72161,724,423248,2635724,75966,54905777,3289,285328,26553,2066,,,,,-42,-3,18,-63,-66,23,79.63,-1.211111,-4.144444,1.211111,0.649111,-2.583333,90.595331
12/31/2020,53946,758,481233,2689670,76724,55406379,2924,288252,26580,2122,,,,,-53,2,14,-67,-69,24,79.63,-1.024691,-5.067901,1.907407,0,-1.975309,93.331775
1/1/2021,32482,751,421447,2722152,77475,55828778,3364,291616,26392,2162,,,,,-83,-64,-5,-82,-83,32,79.63,2.194444,-0.561111,3.661111,0.5715,0.633333,89.541507
1/2/2021,61654,762,412419,2783806,78237,56242006,3440,295056,27564,2256,,,,,-68,-24,-12,-66,-39,16,79.63,-0.574074,-3.660494,1.444444,0.254,-1.716049,92.078186
1/3/2021,56335,763,431195,2840141,79000,56674100,3650,298706,29036,2420,,,,,-64,-24,-8,-62,-29,11,79.63,1.388889,-0.055556,3.05,4.191,0.35,92.894793
1/4/2021,77972,846,469422,2918113,79846,57155766,3937,302643,30778,2560,,,,,-53,-17,-16,-62,-49,19,79.63,1.711111,0.005556,3.211111,3.640667,-0.266667,86.993093
1/5/2021,66637,909,505527,2984750,80755,57668047,4115,306758,30689,2645,,,,,-61,-21,-18,-63,-50,20,87.96,1.105556,-0.366667,2.422222,1.312333,-0.405556,89.851184
1/6/2021,58784,938,560665,3043534,81693,58246792,4396,311154,31948,2821,,,,,-62,-22,-13,-63,-49,21,87.96,-0.227778,-2.638889,1.405556,1.233714,-0.983333,94.69759
1/7/2021,53187,997,621347,3096721,82690,58873328,4294,315448,32584,2929,,,,,-62,-22,-9,-64,-50,21,87.96,-1.266667,-4.772222,0.994444,0.181429,-1.861111,95.783368
1/8/2021,48105,989,682322,3144826,83679,59560998,4002,319450,33780,3098,,,,,-64,-23,-21,-64,-49,22,87.96,-0.694444,-4.177778,0.755556,0.677333,-1.455556,94.645568
1/9/2021,40035,1023,566599,3184861,84702,60129562,4127,323577,34034,3145,,,,,-68,-22,-14,-65,-33,15,87.96,-2.376543,-7.376543,1.506173,17.417143,-3.518519,91.970784
1/10/2021,37174,1099,486834,3222035,85801,60618780,3940,327517,35392,3264,,,,,-68,-27,-13,-65,-31,12,87.96,3.388889,-0.574074,5.030864,1.989667,2.561728,94.43283
