date,new_confirmed,new_deceased,new_tested,cumulative_confirmed,cumulative_deceased,cumulative_tested,new_hospitalized_patients,cumulative_hospitalized_patients,current_hospitalized_patients,current_ventilator_patients,new_persons_vaccinated,cumulative_persons_vaccinated,new_persons_fully_vaccinated,cumulative_persons_fully_vaccinated,mobility_retail_and_recreation,mobility_grocery_and_pharmacy,mobility_parks,mobility_transit_stations,mobility_workplaces,mobility_residential,stringency_index,average_temperature_celsius,minimum_temperature_celsius,maximum_temperature_celsius,rainfall_mm,dew_point,relative_humidity
1/11/2021,58592,1132,543719,3280627,86933,61176472,4310,331827,36753,3363,145076,2431648,20768,412167,-59,-25,-16,-63,-50,20,87.96,6.377778,3.361111,8.433333,0.870857,4.383333,87.407954
1/12/2021,50647,1213,590404,3331274,88146,61797627,4580,336407,36983,3496,207661,2639309,16065,428232,-61,-24,-7,-63,-51,20,87.96,0.122222,-3.033333,4.405556,3.175,-1.8,87.156365
1/13/2021,46509,1219,629223,3377783,89365,62445325,4225,340632,37489,3626,278943,2918252,9745,437977,-64,-27,-30,-65,-50,21,87.96,-0.111111,-3.561111,1.827778,0,-1.016667,93.683546
1/14/2021,43473,1233,696927,3421256,90598,63151470,4100,344732,37693,3672,316694,3234946,5257,443234,-66,-29,-28,-66,-53,22,87.96,0.311111,-1.038889,1.316667,9.779,-0.133333,96.879545
1/15/2021,41451,1229,599603,3462707,91827,63760165,3684,348416,38134,3789,341317,3576263,4208,447442,-64,-23,-15,-64,-51,21,87.96,-2.311111,-5.483333,0.061111,4.572,-3.083333,94.502406
1/16/2021,31249,1311,492549,3493956,93138,64262678,3944,352360,37716,3854,296131,3872394,2620,450062,-70,-26,-31,-67,-35,15,87.96,2.716049,-1.814815,5.87037,14.181667,1.419753,91.262423
1/17/2021,29592,1272,417972,3523548,94410,64688019,3751,356111,38170,3871,190107,4062501,2239,452301,-67,-27,8,-63,-31,11,87.96,3.530864,1.234568,5.037037,4.753429,1.592593,87.47354
1/18/2021,45958,1301,566981,3569506,95711,65281812,4061,360172,39254,3916,204076,4266577,4565,456866,-60,-25,-10,-63,-51,19,87.96,4.494444,3.1,5.544444,0.435429,2.627778,87.935016
1/19/2021,40526,1370,585790,3610032,97081,65896473,4160,364332,38845,3947,343163,4609740,3759,460625,-63,-27,-23,-64,-52,20,87.96,6.033333,3.655556,7.655556,1.566333,5.876543,96.681456
1/20/2021,35986,1302,645198,3646018,98383,66567122,4051,368383,38738,3953,363508,4973248,3411,464036,-65,-28,-35,-66,-51,21,87.96,5.622222,0.783333,7.933333,17.864667,5.083333,96.396888
1/21/2021,32502,1240,665124,3678520,99623,67248276,3637,372020,38058,3960,409855,5383103,2760,466796,-62,-23,-6,-64,-51,20,87.96,2.227778,0.244444,4.3,14.478,0.044444,85.857035
1/22/2021,30330,1247,633418,3708850,100870,67900379,3394,375414,38256,4076,478248,5861351,1821,468617,-62,-20,-3,-63,-49,21,87.96,1.75,-1.066667,3.944444,2.935111,-0.822222,83.56024
1/23/2021,22345,1176,481000,3731195,102046,68388346,3118,378532,37397,4066,491970,6353321,1043,469660,-67,-22,-12,-64,-33,14,87.96,-2.018519,-4.37037,1.185185,0.0635,-2.993827,93.156938
1/24/2021,17554,1159,412802,3748749,103205,68807648,3113,381645,37729,4077,220249,6573570,818,470478,-71,-31,-4,-66,-34,12,87.96,-2.802469,-5.777778,0.802469,0.056444,-3.938272,92.01649
1/25/2021,30737,1171,554417,3779486,104376,69380834,2932,384577,37755,4032,279757,6853327,1968,472446,-59,-23,-1,-62,-52,19,87.96,0.472222,-4.588889,3.972222,0.028222,-1.694444,85.794529
1/26/2021,27730,1068,646599,3807216,105444,70058559,3150,387727,37101,3961,311060,7164387,1710,474156,-62,-25,-27,-64,-51,20,87.96,0.638889,-2.083333,2.366667,1.608667,-0.183333,94.31489
1/27/2021,26303,1117,816338,3833519,106561,70891750,3058,390785,35513,3937,312378,7476765,2329,476485,-60,-21,-13,-63,-50,20,87.96,3.627778,0.438889,6.655556,0.592667,3.016667,95.871433
1/28/2021,24773,1112,777591,3858292,107673,71694842,3044,393829,34909,3918,414419,7891184,1769,478254,-61,-21,-12,-63,-50,20,87.96,2.661111,0.944444,4.766667,6.561667,2.238889,97.08814
1/29/2021,22433,1071,676840,3880725,108744,72390592,2687,396516,33848,3832,487756,8378940,2178,480432,-60,-16,-11,-61,-49,20,87.96,4.277778,0.811111,6.494444,10.414,3.283333,93.353288
1/30/2021,17167,913,449009,3897892,109657,72848366,2469,398985,33016,3806,598389,8977329,10621,491053,-67,-22,-37,-67,-33,15,87.96,0.733333,-1.794444,2.683333,0.508,-1.738889,83.926706
1/31/2021,15783,894,582713,3913675,110551,73462855,2408,401393,32586,3687,319038,9296367,3156,494209,-65,-24,-3,-63,-30,11,87.96,-1.141975,-4.092593,1.358025,0.03175,-2.679012,89.509249
2/1/2021,22972,899,662984,3936647,111450,74154256,2605,403998,32960,3726,350348,9646715,2587,496796,-56,-21,0,-60,-49,18,87.96,0.183333,-3.244444,4.133333,0.0762,-1.883333,86.222407
2/2/2021,20266,854,617757,3956913,112304,74805756,2481,406479,31766,3635,374756,10021471,2166,498962,-61,-24,-13,-62,-51,20,87.96,0.988889,-1.038889,2.577778,1.312333,-0.022222,93.058476
2/3/2021,19914,866,805351,3976827,113170,75630770,2362,408841,30604,3628,469016,10490487,2995,501957,-60,-21,-13,-63,-49,20,87.96,2.3,1.4,3.122222,15.282333,1.644444,95.531362
2/4/2021,18493,722,789095,3995320,113892,76449742,2142,410983,29415,3572,480560,10971047,4036,505993,-60,-20,-12,-64,-49,20,87.96,3.544444,1.666667,4.933333,5.926667,2.861111,95.367891
2/5/2021,16308,756,677783,4011628,114648,77149285,2005,412988,28385,3505,494163,11465210,4064,510057,-59,-14,-1,-61,-48,20,87.96,4.661111,3.616667,5.755556,3.302,4.116667,96.323807
2/6/2021,12320,703,457147,4023948,115351,77618484,1893,414881,26916,3373,549808,12015018,1662,511719,-65,-19,-21,-64,-31,14,87.96,3.012346,0.895062,4.462963,4.910667,2.166667,94.276977
2/7/2021,11664,637,583340,4035612,115988,78221981,1852,416733,26802,3302,278988,12294006,862,512581,-68,-27,-23,-67,-32,11,87.96,-0.05,-1.041667,0.951389,3.217333,-3.422222,78.540544
2/8/2021,16194,680,628631,4051806,116668,78883843,1921,418654,26746,3230,352480,12646486,3811,516392,-60,-24,-13,-63,-52,19,87.96,-1.405556,-3.022222,0.327778,1.651,-4.027778,82.675782
2/9/2021,14225,612,584321,4066031,117280,79497406,1754,420408,25691,3164,411812,13058298,3161,519553,-61,-21,-12,-63,-52,20,87.96,-2.144444,-4.638889,-0.038889,0.8128,-5.338889,79.376799
2/10/2021,13899,610,761963,4079930,117890,80288457,1726,422134,24419,3132,450810,13509108,4894,524447,-59,-17,-8,-62,-50,20,87.96,-3.679012,-6.271605,-1.790123,10.668,-5.37037,88.282966
2/11/2021,13139,576,731382,4093069,118466,81063310,1680,423814,23413,3036,503116,14012224,5647,530094,-58,-15,-8,-63,-49,20,87.96,,,,,,
2/12/2021,12573,535,626736,4105642,119001,81712692,1511,425325,22326,2943,544603,14556827,4775,534869,-58,-10,-14,-62,-48,20,87.96,,,,,,
2/13/2021,9035,494,406691,4114677,119495,82132538,1428,426753,20972,2842,505362,15062189,2846,537715,-63,-11,-28,-65,-31,14,87.96,-1.981481,-2.962963,-1.123457,0,-8.487654,62.236987
2/14/2021,8994,498,401576,4123671,119993,82542391,1538,428291,21056,2851,237962,15300151,1915,539630,-65,-21,-28,-65,-30,11,87.96,1.123457,-1.746914,3.339506,20.1168,-2.080247,79.516256
2/15/2021,14735,519,466784,4138406,120512,83032709,1503,429794,20996,2805,275956,15576107,6535,546165,-52,-16,18,-60,-53,18,87.96,5.697531,2.364198,9.154321,3.358444,4.6875,90.954179
2/16/2021,12941,447,495219,4151347,120959,83552514,1495,431289,20217,2708,364865,15940972,12412,558577,-55,-13,5,-61,-52,19,87.96,7.037037,3.518519,9.802469,2.286,5.388889,86.047975
2/17/2021,11942,432,579872,4163289,121391,84147458,1411,432700,19451,2614,482110,16423082,15147,573724,-55,-16,1,-61,-51,20,87.96,6.617284,3.759259,8.925926,2.0828,4.138889,80.926533
2/18/2021,11794,421,561826,4175083,121812,84729447,1339,434039,18524,2535,452454,16875536,15867,589591,-55,-13,13,-61,-52,20,87.96,6.37037,4.512346,8.746914,1.6256,4.104167,81.923592
2/19/2021,10728,382,524758,4185811,122194,85272050,1272,435311,17862,2469,371906,17247442,15294,604885,-57,-12,-7,-61,-51,20,87.96,4.685185,2.759259,7.104938,3.090333,2.314815,84.777398
2/20/2021,8313,352,405408,4194124,122546,85687090,1091,436402,17044,2358,334679,17582121,10263,615148,-62,-14,-4,-61,-28,13,87.96,10.066667,8.533333,10.844444,0,8.319444,82.620199
2/21/2021,8097,327,591085,4202221,122873,86287789,1157,437559,16859,2329,141719,17723840,9177,624325,-60,-18,27,-57,-26,10,87.96,7.805556,6.229167,9.673611,0.254,5.430556,85.271328
2/22/2021,11656,282,678459,4213877,123155,87001800,1120,438679,16857,2273,192341,17916181,18463,642788,-52,-16,13,-59,-47,17,86.11,6.141975,2.32716,9.493827,1.8288,4.381944,85.298309
2/23/2021,9763,290,600774,4223640,123445,87646375,1120,439799,16117,2149,326692,18242873,26317,669105,-55,-15,7,-59,-47,18,86.11,8.148148,3.080247,11.41358,1.27,5.583333,81.021664
2/24/2021,8846,275,740392,4232486,123720,88408971,1022,440821,15536,2118,448962,18691835,31613,700718,-54,-13,6,-59,-46,19,86.11,9.91358,7.345679,11.814815,14.3256,8.104938,88.853422
2/25/2021,8025,260,732293,4240511,123980,89181354,971,441792,14851,2047,485720,19177555,35319,736037,-53,-10,22,-59,-46,18,86.11,5.734568,1.611111,8.524691,2.939143,2.617284,80.935537
2/26/2021,6783,229,606952,4247294,124209,89813224,864,442656,14079,1971,504493,19682048,32773,768810,-51,-5,38,-56,-45,18,86.11,3.962963,-1.104938,8.962963,0,1.82716,86.319797
2/27/2021,4949,230,381390,4252243,124439,90206491,742,443398,13271,1903,407503,20089551,27322,796132,-56,-9,38,-56,-25,11,86.11,5.25,0.277778,10.180556,0.09525,3.215278,86.981367
2/28/2021,4873,215,527220,4257116,124654,90753674,771,444169,12790,1783,185900,20275451,19684,815816,-55,-12,48,-55,-23,9,86.11,4.024691,-0.37037,9.302469,0,1.868056,84.58599
3/1/2021,7192,224,736972,4264308,124878,91542503,825,444994,12896,1806,203168,20478619,28282,844098,-49,-12,20,-57,-46,17,86.11,2.697531,-2.592593,7.438272,0.028222,0.845679,88.015978
3/2/2021,6919,185,680103,4271227,125063,92277458,835,445829,12141,1709,224996,20703615,51314,895412,-52,-12,16,-58,-46,17,86.11,2.580247,0.339506,4.91358,0.042333,-0.012346,85.345679
3/3/2021,6172,147,861334,4277399,125210,93167675,713,446542,11525,1647,278956,20982571,68450,963862,-54,-13,-7,-59,-46,18,86.11,1.518519,-0.944444,3.611111,0,-0.358025,88.506789
3/4/2021,5937,154,994447,4283336,125364,94215351,706,447248,10935,1589,376244,21358815,70206,1034068,-54,-10,-1,-59,-46,18,86.11,2.462963,0.703704,5.006173,0.4572,0.907407,89.602945
3/5/2021,5467,169,952887,4288803,125533,95225962,599,447847,10314,1542,437463,21796278,56772,1090840,-53,-6,8,-57,-44,18,86.11,1.864198,-0.271605,3.790123,0.653143,-1.080247,81.041424
3/6/2021,4628,153,452587,4293431,125686,95708984,636,448483,9713,1449,416834,22213112,31562,1122402,-57,-9,10,-58,-24,12,86.11,1.549383,-1.030864,4.283951,0.084667,-2.432099,75.200835
3/7/2021,4410,133,806934,4297841,125819,96534965,535,449018,9461,1394,164143,22377255,20241,1142643,-56,-12,30,-56,-22,9,86.11,3.450617,-1.617284,7.950617,0,0.185185,79.692422
3/8/2021,6890,144,1537849,4304731,125963,98154222,576,449594,9476,1356,215273,22592528,38788,1181431,-47,-8,16,-54,-44,15,82.41,5.722222,2.277778,7.87037,0.762,3.87037,88.147184
3/9/2021,6488,138,1379642,4311219,126101,99663934,579,450173,9011,1292,217301,22809829,72922,1254353,-49,-8,31,-52,-43,15,82.41,6.179012,3.308642,8.351852,0.465667,3.975309,86.195003
3/10/2021,6251,118,1554753,4317470,126219,101332623,567,450740,8438,1236,243887,23053716,97162,1351515,-55,-12,-26,-57,-42,17,82.41,7.067901,4.166667,10.259259,9.144,5.604938,90.601312
3/11/2021,5933,125,1615476,4323403,126344,103069455,551,451291,8069,1192,260809,23314525,93563,1445078,-53,-6,-4,-55,-42,17,82.41,5.753086,2.981481,8.197531,14.986,2.475309,79.684214
3/12/2021,5716,95,1405524,4329119,126439,104594425,480,451771,7731,1110,369578,23684103,87676,1532754,-52,-1,-1,-53,-40,16,82.41,4.277778,2.734568,6.45679,3.0988,1.074074,80.140478
3/13/2021,4379,106,437728,4333498,126545,105066338,463,452234,7387,1087,512108,24196211,52155,1584909,-56,2,-11,-58,-23,12,80.56,3.541667,1.416667,6.368056,5.8928,1.236111,85.219653
3/14/2021,4425,98,965197,4337923,126643,106058723,428,452662,7319,1049,257010,24453221,25371,1610280,-58,-10,4,-54,-14,8,80.56,5,2.716049,7.296296,0.931333,2.123457,82.062184
3/15/2021,6698,96,1583357,4344621,126739,107751659,503,453165,7210,1016,386685,24839906,53366,1663646,-47,-9,23,-51,-41,14,78.7,6.166667,2.185185,9.882716,0.4572,2.3125,73.351998
3/16/2021,5849,83,1327955,4350470,126822,109197567,441,453606,6849,968,433320,25273226,95799,1759445,-49,-8,23,-51,-41,15,78.7,8.481481,3.092593,13.895062,0.423333,4.925926,78.698419
3/17/2021,5976,81,1636612,4356446,126903,110935170,445,454051,6587,925,462246,25735472,119609,1879054,-49,-7,26,-51,-40,15,78.7,5.635802,0.703704,10.938272,0.508,1.135802,73.017347
3/18/2021,5623,59,1436081,4362069,126962,112509054,451,454502,6152,879,528260,26263732,132016,2011070,-51,-5,18,-52,-40,16,78.7,7.592593,2.345679,13.648148,0,4.932099,83.400883
3/19/2021,5176,70,940208,4367245,127032,113536149,380,454882,5882,830,614930,26878662,125725,2136795,-51,-2,25,-50,-39,16,78.7,6.487654,5.234568,8.037037,0.254,5.6875,91.38231
3/20/2021,4246,64,471045,4371491,127096,114038857,364,455246,5569,787,752308,27630970,91977,2228772,-57,-7,16,-55,-22,11,78.7,7.701389,4.743056,11.694444,0.22225,5.486111,86.19854
3/21/2021,5388,81,1895480,4376879,127177,115958702,358,455604,5450,768,367006,27997976,52612,2281384,-55,-11,42,-53,-19,8,78.7,6.845679,2.271605,10.648148,0,3.061728,77.418929
3/22/2021,6458,68,1205749,4383337,127245,117301419,361,455965,5433,748,329897,28327873,82300,2363684,-45,-6,42,-49,-40,14,78.7,5.462963,-0.635802,10.45679,0,2.345679,80.799335
3/23/2021,5481,52,848978,4388818,127297,118230677,368,456333,5152,711,325650,28653523,169155,2532839,-48,-6,28,-50,-40,14,78.7,7.080247,4.388889,9.08642,0,3.17284,76.876537
3/24/2021,6224,42,1812582,4395042,127339,120094548,350,456683,4882,682,337665,28991188,242642,2775481,-48,-5,28,-51,-39,15,78.7,7.339506,4.191358,10.160494,0.889,2.895062,74.326885
3/25/2021,5616,46,1275669,4400658,127385,121534407,341,457024,4585,630,324942,29316130,234382,3009863,-49,-3,26,-51,-40,15,78.7,7.611111,4.679012,10.537037,1.481667,4.208333,75.811398
3/26/2021,4567,48,723043,4405225,127433,122293829,298,457322,4487,615,411305,29727435,283654,3293517,-51,-1,-1,-51,-39,16,78.7,6,2.234568,9.074074,0.8128,1.820988,75.437413
3/27/2021,3731,39,471603,4408956,127472,122795052,273,457595,4438,594,424301,30151736,238861,3532378,-55,-5,19,-54,-21,11,70.37,4.888889,1.013889,7.805556,2.54,0.645833,74.840725
3/28/2021,5029,34,1644848,4413985,127506,124465936,273,457868,4187,582,293548,30445284,147594,3679972,-58,-14,-1,-57,-22,9,70.37,10.253086,6.864198,12.580247,11.1252,7.993056,82.467783
3/29/2021,4196,37,981583,4418181,127543,125495721,251,458119,4199,583,236809,30682093,168230,3848202,-41,-2,71,-48,-42,13,70.37,11.722222,9.611111,14.0625,11.33475,8.5625,81.576202
3/30/2021,3779,43,701962,4421960,127586,126244515,257,458376,3978,568,225917,30908010,277682,4125884,-42,1,110,-46,-42,13,70.37,11.576389,6.854167,16.854167,0.5715,6.479167,71.998515
3/31/2021,3967,39,1267481,4425927,127625,127567695,270,458646,3744,547,239434,31147444,387574,4513458,-42,4,69,-47,-41,14,70.37,11.256944,6.020833,18.152778,0,7.104167,76.052095
4/1/2021,3674,32,953784,4429601,127657,128646556,234,458880,3559,517,170818,31318262,445416,4958874,-39,15,53,-47,-42,13,70.37,4.798611,1.1875,6.854167,0.084667,1.506944,79.657574
4/2/2021,2747,32,553474,4432348,127689,129263386,237,459117,3378,485,107420,31425682,246631,5205505,-49,0,77,-58,-68,21,70.37,4.486111,-0.090278,8.729167,0,0.708333,76.918429
4/3/2021,2506,31,407008,4434854,127720,129705141,222,459339,3246,478,107886,31533568,178913,5384418,-55,2,35,-52,-27,9,70.37,5.420635,0.412698,9.777778,0,0.904762,72.701179
4/4/2021,2413,27,815680,4437267,127747,130550640,197,459536,3231,469,48055,31581623,47708,5432126,-69,-40,72,-49,-23,6,70.37,6.618056,0.444444,12.180556,0,2.291667,74.529701
4/5/2021,2744,19,746399,4440011,127766,131427948,238,459774,3257,461,40744,31622367,64590,5496716,-47,-13,65,-65,-75,23,70.37,1.840278,-1.715278,5.590278,0.1524,-6.736111,53.78937
4/6/2021,3312,28,635483,4443323,127794,132163113,223,459997,3145,453,85227,31707594,186793,5683509,-45,-3,34,-53,-50,16,70.37,0.590278,-2.902778,3.722222,0.1524,-6.798611,58.35973
4/7/2021,3253,28,1036251,4446576,127822,133251654,235,460232,3021,440,99530,31807124,408396,6091905,-46,-5,35,-53,-48,16,70.37,1.944444,-3.290123,5.339506,0,-6.092593,55.904142
4/8/2021,3147,35,935104,4449723,127857,134306011,207,460439,2874,421,96242,31903366,449269,6541174,-46,-3,46,-53,-47,16,70.37,6.138889,1.340278,8.770833,0.677333,2.729167,79.300755
4/9/2021,2952,27,678914,4452675,127884,135060241,206,460645,2796,405,106878,32010244,450136,6991310,-48,-3,44,-51,-46,16,70.37,3.901235,-1.080247,7.216049,1.1684,-1.41358,68.638335
4/10/2021,2380,25,481757,4455055,127909,135579867,186,460831,2654,385,111109,32121353,475230,7466540,-57,-7,11,-53,-21,10,70.37,0.714286,-4.928571,6.420635,0,-3.31746,74.432564
4/11/2021,2376,24,1218924,4457431,127933,136835423,205,461036,2553,385,69223,32190576,189665,7656205,-52,-9,45,-48,-17,7,70.37,0.888889,-3.638889,5.548611,0.5588,-3.333333,73.799223
4/12/2021,2880,29,884718,4460311,127962,137868931,205,461241,2496,377,59905,32250481,201191,7857396,-19,0,59,-40,-42,11,61.11,2.067901,-4.32716,7.512346,0.254,-4.209877,63.318302
4/13/2021,2495,21,684313,4462806,127983,138628571,181,461422,2411,370,76123,32326604,312685,8170081,-26,1,63,-42,-43,12,61.11,3.82716,-2.82716,8.728395,0,-0.944444,71.514311
4/14/2021,2512,18,1164115,4465318,128001,139842224,197,461619,2297,351,117835,32444439,343783,8513864,-26,1,63,-42,-42,12,61.11,4.977778,-0.783333,10.044444,0.1524,-0.566667,67.600608
4/15/2021,2345,22,991865,4467663,128023,140960949,161,461780,2198,329,129782,32574221,417683,8931547,-27,3,68,-42,-41,12,61.11,4.8,-2.483333,10.905556,0.0254,-2.477778,59.906669
4/16/2021,2347,19,682205,4470010,128042,141724010,160,461940,2143,332,135557,32709778,499664,9431211,-30,3,68,-39,-40,11,61.11,5.512346,-2.259259,11.919753,0,-1.104938,62.610119
4/17/2021,1722,25,491778,4471732,128067,142253327,159,462099,2038,323,139445,32849223,499635,9930846,-37,-1,64,-34,-16,5,61.11,6.654321,-0.555556,12.641975,0,-0.345679,61.152447
4/18/2021,2584,18,1677731,4474316,128085,143972227,141,462240,1986,311,83225,32932448,221193,10152039,-33,-2,70,-33,-13,4,61.11,7.376543,1.37037,12.475309,0,0.265432,61.134285
4/19/2021,2738,18,1052307,4477054,128103,145218501,179,462419,2010,318,99672,33032120,273751,10425790,-25,2,72,-38,-34,10,61.11,8.572222,1.105556,15.016667,0,1,59.413162
4/20/2021,2541,19,735426,4479595,128122,146066237,134,462553,1929,300,107622,33139742,350027,10775817,-29,2,60,-38,-34,10,61.11,8.861111,1.8,14.605556,0,2.744444,65.978101
4/21/2021,2709,24,1371537,4482304,128146,147487751,173,462726,1896,276,117909,33257651,416784,11192601,-29,1,45,-41,-33,11,61.11,6.716667,1.272222,9.822222,0,0.227778,63.911094
4/22/2021,2409,17,1113288,4484713,128163,148753910,122,462848,1794,261,130986,33388637,431070,11623671,-28,3,71,-40,-32,10,61.11,7.316667,-1.677778,14.483333,0,-3.316667,47.40315
4/23/2021,2020,23,725741,4486733,128186,149564957,157,463005,1752,243,135786,33524423,465015,12088686,-29,5,69,-37,-31,9,61.11,9.711111,1.294444,16.327778,0,-2.1,44.503481
4/24/2021,1564,8,500713,4488297,128194,150101170,130,463135,1676,240,148767,33673190,547636,12636322,-34,2,66,-35,-14,5,61.11,8.141975,3.024691,12.617284,0,2.95679,70.001209
4/25/2021,2119,15,1479341,4490416,128209,151619604,138,463273,1629,231,79695,33752885,260801,12897123,-31,-2,68,-37,-12,4,61.11,6.030864,-0.567901,11.339506,0,1.098765,70.915421
4/26/2021,2627,14,1045240,4493043,128223,152845593,135,463408,1652,227,90695,33843580,304688,13201811,-24,1,55,-39,-33,10,61.11,6.844444,-1.172222,12.183333,0,2.15,72.175743
4/27/2021,2177,16,734771,4495220,128239,153676183,169,463577,1575,214,116328,33959908,379265,13581076,-30,0,41,-40,-33,11,61.11,6.333333,3.766667,9.183333,1.524,3.855556,84.427189
4/28/2021,2499,16,1358139,4497719,128255,155090374,112,463689,1518,208,134140,34094048,462885,14043961,-30,1,21,-42,-33,11,61.11,5.422222,2.172222,7.916667,4.064,1.761111,77.795754
4/29/2021,2230,16,1074231,4499949,128271,156318604,103,463792,1467,196,122568,34216616,491567,14535528,-28,4,41,-40,-32,11,61.11,4.088889,0.116667,7.583333,1.016,0.272222,76.673315
4/30/2021,1825,12,667757,4501774,128283,157067397,114,463906,1369,185,145589,34362205,421785,14957313,-26,8,46,-36,-31,9,61.11,4.191358,-0.08642,7.648148,1.3716,1.277778,81.591429
5/1/2021,1431,9,484465,4503205,128292,157586281,102,464008,1290,188,143175,34505380,372304,15329617,-31,3,44,-35,-15,5,61.11,4,-1.111111,8.381944,0.544286,-0.236111,74.087443
5/2/2021,1521,14,834751,4504726,128306,158456462,120,464128,1288,196,89924,34595304,172891,15502508,-26,-2,71,-34,-14,3,61.11,5.734568,0.141975,10.037037,0.072571,0.67284,70.262611
5/3/2021,2084,9,1076424,4506810,128315,159676828,123,464251,1306,187,72600,34667904,127499,15630007,-29,-11,30,-58,-73,21,59.72,5.185185,0.5,8.62963,9.059333,3.055556,86.295044
5/4/2021,2551,10,872074,4509361,128325,160683484,103,464354,1299,181,127170,34795074,257486,15887493,-31,3,19,-41,-34,11,59.72,4.697531,2.123457,7.382716,14.520333,2.555556,86.332739
5/5/2021,2569,13,1207455,4511930,128338,161952445,120,464474,1243,182,139097,34934171,404226,16291719,-29,2,30,-40,-32,11,59.72,4.311111,0.294444,8.994444,1.100667,-1.227778,67.712658
5/6/2021,2325,11,1068411,4514255,128349,163187701,120,464594,1163,163,135470,35069641,473001,16764720,-27,6,45,-39,-32,10,59.72,3.12963,-2.858025,7.623457,1.820333,0.135802,81.172901
5/7/2021,1981,12,709120,4516236,128361,163949388,104,464698,1161,159,133001,35202642,465822,17230542,-28,4,52,-37,-29,9,59.72,5.038889,-0.45,9.805556,1.693333,1.583333,78.485415
5/8/2021,1608,10,490991,4517844,128371,164476624,111,464809,1141,151,169027,35371669,438837,17669379,-42,-3,-18,-46,-16,9,59.72,5.994444,0.161111,11.8,1.608667,4.522222,90.354772
5/9/2021,2307,9,1323041,4520151,128380,165834737,103,464912,1122,144,100626,35472295,187171,17856550,-30,-3,57,-36,-11,4,59.72,11.688889,8.488889,14.533333,6.50875,7.833333,77.67584
5/10/2021,2808,10,965959,4522959,128390,166963960,105,465017,1133,149,115053,35587348,231835,18088385,-26,1,41,-39,-32,10,59.72,10.294444,6.966667,13.75,1.185333,6.911111,79.903633
5/11/2021,2328,15,715994,4525287,128405,167772892,109,465126,1110,138,135113,35722461,350147,18438532,-27,2,46,-39,-31,10,59.72,8.894444,4.394444,14.155556,1.524,5.233333,78.137513
5/12/2021,2334,12,1205267,4527621,128417,169026815,122,465248,1073,136,184210,35906671,452437,18890969,-25,5,42,-39,-31,10,59.72,8.894444,3.638889,13.216667,4.717143,5.644444,80.307977
5/13/2021,2182,7,1028069,4529803,128424,167730656,103,465351,1006,129,209284,36115955,428041,19319010,-29,3,32,-41,-32,11,59.72,8.5,3.472222,13.272222,0.635,6.205556,85.538746
5/14/2021,1936,6,700921,4531739,128430,168513150,97,465448,982,124,220068,36336023,393402,19712412,-27,6,45,-37,-30,10,59.72,7.588889,5.311111,10.472222,1.185333,4.916667,83.31684
5/15/2021,1626,8,482909,4533365,128438,169026475,91,465539,972,121,237331,36573354,391246,20103658,-34,2,16,-38,-15,6,59.72,8.616667,6.233333,11.005556,0.181429,5.461111,80.841636
5/16/2021,1922,9,1111768,4535287,128447,170176278,81,465620,947,123,131318,36704672,183745,20287403,-32,-2,30,-39,-10,5,59.72,9.339506,7.41358,12.407407,4.953,7.049383,85.797701
5/17/2021,2858,9,1005482,4538145,128456,171430196,102,465722,949,125,106733,36811405,259049,20546452,-17,1,40,-35,-30,9,62.5,8.75,5.527778,12.494444,3.979333,6.144444,83.884567
5/18/2021,2812,6,752844,4540957,128462,172289797,128,465850,904,124,174100,36985505,324001,20870453,-20,3,49,-36,-30,9,62.5,9.127778,3.377778,14.122222,4.41325,4.666667,73.898015
5/19/2021,2812,5,1188909,4543769,128467,173530131,126,465976,922,122,264858,37250363,369018,21239471,-18,4,51,-36,-29,9,62.5,9.527778,3.783333,13.916667,0.399143,4.677778,71.943914
5/20/2021,2517,6,998144,4546286,128473,174685077,132,466108,916,123,268251,37518614,420312,21659783,-24,3,20,-41,-30,10,62.5,7.794444,3.122222,10.111111,0.635,6.116667,89.266173
5/21/2021,2365,10,724810,4548651,128483,175482320,125,466233,926,124,219657,37738271,426683,22086466,-25,4,12,-36,-29,9,62.5,9.088889,5.794444,11.372222,13.716,8.351852,91.88082
5/22/2021,2000,5,494869,4550651,128488,176011121,119,466352,891,123,205410,37943681,556951,22643417,-24,3,35,-31,-9,3,62.5,6.761111,3.7,9.677778,3.1115,3.133333,77.937724
5/23/2021,2326,9,1171568,4552977,128497,177219896,116,466468,928,120,126357,38070038,252139,22895556,-24,-4,21,-34,-9,3,62.5,7.577778,2.933333,11.261111,0.931333,4.65,82.10262
5/24/2021,3368,9,970884,4556345,128506,178340975,139,466607,965,121,122379,38192417,332955,23228511,-19,3,38,-38,-31,9,62.5,8.972222,4.083333,13.244444,7.547429,4.361111,73.314954
5/25/2021,3427,7,748922,4559772,128513,179200097,133,466740,926,128,186147,38378564,387987,23616498,-20,5,42,-38,-30,9,62.5,8.694444,6.394444,11.816667,1.608667,6.166667,84.405679
5/26/2021,3921,13,1134125,4563693,128526,180389107,132,466872,900,125,236119,38614683,427458,24043956,-17,6,50,-37,-29,9,62.5,9.166667,5.85,12.738889,4.445,7.088889,86.964554
5/27/2021,3747,9,962255,4567440,128535,181482777,127,466999,877,120,256517,38871200,434096,24478052,-12,9,85,-35,-29,8,62.5,11.122222,5.438889,16.244444,0.5334,7.194444,76.809807
5/28/2021,3589,8,679418,4571029,128543,182225754,139,467138,891,124,204442,39075642,435951,24914003,-11,12,68,-29,-30,6,62.5,12.188889,7.15,16.122222,0,8.377778,77.716286
5/29/2021,3000,9,483475,4574029,128552,182740165,105,467243,892,119,183526,39259168,418848,25332851,-18,6,78,-22,-10,1,62.5,13.816667,7.566667,19.205556,0,9.622222,75.936339
5/30/2021,3164,9,626632,4577193,128561,183392783,112,467355,912,124,124887,39384055,206322,25539173,-5,7,130,-18,-7,-1,62.5,13.45,7.35,19.238889,0,7.827778,69.078082
5/31/2021,3897,8,612190,4581090,128569,184085462,124,467479,934,122,93103,39477158,195546,25734719,-1,2,203,-42,-71,12,62.5,13.122222,5.872222,19.177778,0,7.9,70.994356
6/1/2021,5431,4,672280,4586521,128573,184863504,157,467636,935,136,108507,39585665,338565,26073284,-5,15,141,-34,-43,8,62.5,15.15,7.755556,21.4,0,8.338889,63.922182
6/2/2021,6168,13,853146,4592689,128586,185766106,131,467767,966,129,172763,39758428,349019,26422303,-6,11,113,-36,-42,10,62.5,13.855556,7.933333,19.322222,0,8.761111,71.773793
6/3/2021,6256,12,811860,4598945,128598,186675625,129,467896,943,134,191266,39949694,377641,26799944,-6,11,118,-37,-41,9,62.5,13.666667,9.816667,17.927778,0.381,10.488889,81.289561
6/4/2021,5860,13,672842,4604805,128611,187401840,126,468022,970,130,179924,40129618,388031,27187975,-13,8,80,-35,-39,9,62.5,12.733333,7.105556,17.516667,0,6.616667,66.707121
6/5/2021,4731,7,482904,4609536,128618,187917273,128,468150,943,135,203613,40333231,473378,27661353,-20,6,81,-25,-7,1,51.39,14.244444,6.244444,19.866667,0,7.772222,65.384787
6/6/2021,5533,8,1241214,4615069,128626,189194567,156,468306,969,145,127345,40460576,259941,27921294,-15,3,77,-26,-3,1,51.39,14.494444,10.272222,18.644444,0,9.7,73.011334
6/7/2021,7945,6,947875,4623014,128632,190269444,177,468483,1040,148,112941,40573517,306068,28227362,-10,10,88,-35,-31,8,51.39,14.766667,9.427778,19.711111,0.145143,10.783333,77.252817
6/8/2021,7896,10,727790,4630910,128642,191081685,189,468672,1062,154,136802,40710319,313482,28540844,-11,11,94,-35,-29,8,51.39,14.277778,8.316667,18.805556,0.2286,9.466667,73.471458
6/9/2021,8210,9,1087814,4639120,128651,192213318,191,468863,1069,159,176559,40886878,316258,28857102,-11,10,79,-35,-29,8,51.39,16.1,9.655556,20.555556,0.254,11.794444,76.367756
6/10/2021,8042,13,947451,4647162,128664,193299131,201,469064,1100,158,201607,41088485,308038,29165140,-12,11,79,-35,-28,8,51.39,16.811111,13.5,19.561111,0.15875,14.061728,80.931935
6/11/2021,7619,6,737355,4654781,128670,194113530,180,469244,1082,161,208531,41297016,307192,29472332,-15,10,72,-32,-27,7,51.39,15.016667,11.727778,17.305556,0.127,11.358025,75.893144
6/12/2021,6284,14,525563,4661065,128684,194673872,178,469422,1111,169,254185,41551201,320326,29792658,-21,7,78,-26,-5,1,51.39,13.744444,9.044444,18.083333,0,7.883333,68.497647
6/13/2021,7135,11,1051847,4668200,128695,195758448,223,469645,1146,188,147228,41698429,181121,29973779,-19,4,92,-24,-3,0,51.39,16.661111,11.088889,21.105556,0,13.104938,76.589902
6/14/2021,10362,11,945417,4678562,128706,196837379,227,469872,1187,188,132627,41831056,235928,30209707,-12,9,81,-35,-30,8,51.39,13.566667,9.4,16.1,0.072571,9.072222,74.763994
6/15/2021,10796,21,778533,4689358,128727,197722516,230,470102,1237,206,190033,42021089,230666,30440373,-12,11,88,-35,-29,8,51.39,13.816667,6.505556,19.555556,0,7.35,65.458837
6/16/2021,11052,13,1104895,4700410,128740,198879877,230,470332,1262,208,195565,42216654,234834,30675207,-12,10,77,-35,-29,8,51.39,15.594444,11.011111,19.994444,0,11.272222,76.387681
6/17/2021,11106,6,1038991,4711516,128746,200061474,245,470577,1327,210,243978,42460632,223260,30898467,-15,9,60,-37,-29,9,51.39,14.794444,11.016667,18.866667,0.0508,9.588889,71.049414
6/18/2021,10320,12,791463,4721836,128758,200916207,239,470816,1369,223,223140,42683772,205677,31104144,-19,6,34,-34,-29,8,51.39,12.622222,8.188889,16.472222,0.056444,8.5,76.006683
6/19/2021,8446,23,585964,4730282,128781,201531946,211,471027,1354,215,280241,42964013,236363,31340507,-21,6,44,-30,-6,2,51.39,13.383333,8.638889,17.711111,0.141111,9.05,75.327632
6/20/2021,10088,25,1149505,4740370,128806,202716559,207,471234,1389,210,163750,43127763,109408,31449915,-14,1,45,-30,-2,1,51.39,12.216667,7.622222,16.761111,1.27,7.127778,71.282744
6/21/2021,16307,16,1037160,4756677,128822,203889564,233,471467,1523,228,21080,43148843,39325,31489240,-16,3,45,-38,-31,9,51.39,10.238889,6.177778,13.305556,0.108857,6.594444,78.315223
6/22/2021,17403,13,823392,4774080,128835,204801683,241,471708,1547,250,299837,43448680,250875,31740115,-14,6,70,-36,-30,8,51.39,11.259259,4.012346,17.154321,0,4.932099,65.127528
6/23/2021,18350,8,1149363,4792430,128843,206002444,275,471983,1501,246,207647,43656327,167988,31908103,-13,6,73,-36,-29,9,51.39,12.469136,4.919753,16.740741,0.169333,8.734568,78.659932
6/24/2021,18712,22,1080844,4811142,128865,207214032,255,472238,1522,259,221534,43877861,177813,32085916,-13,7,69,-36,-30,9,51.39,15.882716,12.530864,21.197531,0.635,12.203704,79.197677
6/25/2021,18169,22,851871,4829311,128887,208128475,258,472496,1544,257,202497,44080358,174770,32260686,-14,8,54,-32,-29,7,51.39,10.364198,9.493827,12.685185,7.874,9.6875,91.770076
6/26/2021,16301,17,610924,4845612,128904,208775295,268,472764,1550,256,234441,44314799,199505,32460191,-19,2,62,-26,-6,2,51.39,11.87037,9.604938,14.419753,3.447143,10.555556,91.81887
6/27/2021,18502,22,1210109,4864114,128926,210024750,267,473031,1611,263,139712,44454511,123555,32583746,-16,-1,52,-28,-4,1,51.39,13.537037,10.641975,16.604938,0.225778,11.222222,85.955536
6/28/2021,28418,13,1112511,4892532,128939,211272955,310,473341,1749,297,127260,44581771,138016,32721762,-12,6,63,-36,-32,8,51.39,15.466667,10.566667,20.016667,0,10.544444,72.874203
6/29/2021,28199,25,883097,4920731,128964,212265400,368,473709,1752,283,137991,44719762,150688,32872450,-16,2,57,-38,-33,8,51.39,15.377778,10.711111,19.627778,0,10.377778,72.590211
6/30/2021,28923,23,1248762,4949654,128987,213568769,417,474126,1831,287,141216,44860978,175749,33048199,-12,6,67,-37,-31,8,51.39,12.623457,8.382716,16.154321,0,8.944444,78.396524
7/1/2021,28794,25,1122235,4978448,129012,214824236,373,474499,1941,300,152525,45013503,193066,33241265,-11,9,90,-35,-31,8,51.39,13.740741,8.191358,19.314815,0,7.296296,65.646877
7/2/2021,26340,29,876251,5004788,129041,215769633,391,474890,2018,321,123605,45137108,177478,33418743,-14,8,79,-31,-30,7,51.39,15.105556,10.9,19.138889,0,11.388889,78.615876
7/3/2021,24010,29,655159,5028798,129070,216464249,396,475286,2062,327,137389,45274497,196209,33614952,-22,2,34,-29,-7,3,51.39,15.144444,11.505556,17.705556,3.979333,13.766667,91.590826
7/4/2021,25170,29,1277488,5053968,129099,217782690,470,475756,2182,336,77222,45351719,111410,33726362,-17,-2,40,-28,-5,2,51.39,15.744444,12.716667,20.233333,6.985,13.744444,88.031452
7/5/2021,34919,29,1177790,5088887,129128,219062112,521,476277,2369,369,76962,45428681,147814,33874176,-11,6,68,-36,-32,9,51.39,14.527778,11.794444,17.544444,12.192,10.933333,79.189002
7/6/2021,36060,32,969123,5124947,129160,220138267,577,476854,2491,392,85811,45514492,153126,34027302,-16,5,48,-38,-32,10,51.39,12.538889,10.488889,14.927778,7.789333,10.911111,89.973601
7/7/2021,38597,29,1234183,5163544,129189,221426435,571,477425,2686,417,86953,45601445,171477,34198779,-12,7,58,-36,-32,9,51.39,15.222222,9.811111,20.072222,4.027714,11.327778,77.692353
7/8/2021,34016,42,1115031,5197560,129231,222667632,608,478033,2773,417,96430,45697875,175467,34374246,-12,7,82,-36,-32,9,51.39,15.033333,9.661111,19.022222,0.1524,11.172222,78.239866
7/9/2021,32803,48,905424,5230363,129279,223637677,558,478591,2944,437,90083,45787958,178819,34553065,-14,7,75,-32,-31,8,51.39,15.544444,11.244444,18.966667,0.0635,12.605556,82.900825
7/10/2021,28379,42,740446,5258742,129321,224416254,552,479143,3041,448,93763,45881721,211446,34764511,-20,3,48,-28,-7,3,51.39,15.461111,12.333333,19.316667,1.524,13.627778,88.93358
7/11/2021,30503,35,1121822,5289245,129356,225579015,594,479737,3187,454,42000,45923721,107620,34872131,-14,5,55,-23,-1,0,51.39,16.222222,12.85,19.738889,5.30225,13.533333,84.362581
7/12/2021,44512,41,1088730,5333757,129397,226853575,732,480469,3463,482,54296,45978017,125360,34997491,-16,0,56,-37,-38,10,51.39,14.966667,13.472222,16.877778,2.159,13.644444,91.894001
7/13/2021,47706,50,934109,5381463,129447,227898923,750,481219,3678,522,59073,46037090,158276,35155767,-13,7,87,-36,-34,9,51.39,15.733333,12.783333,19.394444,9.071429,12.905556,83.360856
7/14/2021,54909,43,1206792,5436372,129490,229163550,755,481974,3862,545,60374,46097464,185661,35341428,-10,8,89,-35,-33,9,51.39,16.922222,11.694444,21.577778,0,13.222222,79.022915
7/15/2021,62000,52,1182258,5498372,129542,230480736,775,482749,4043,551,61681,46159145,201893,35543321,-11,10,96,-35,-33,9,51.39,16.4,11.255556,20.416667,0,12.194444,76.264745
7/16/2021,55263,52,973506,5553635,129594,231516966,700,483449,4156,573,69491,46228636,202314,35745635,-13,10,98,-30,-32,7,51.39,18.6,10.588889,24.333333,0,13.327778,71.606419
7/17/2021,38475,52,779722,5592110,129646,232334092,710,484159,4236,583,67217,46295853,225214,35970849,-23,5,83,-24,-8,1,51.39,20.933333,13.6,26.855556,0,14.633333,67.767659
7/18/2021,36181,69,1041938,5628291,129715,233422658,799,484958,4352,582,18186,46314039,128878,36099727,-16,4,93,-22,-4,0,51.39,18.855556,13.566667,24.527778,0,14.183333,74.485209
7/19/2021,47924,82,1090802,5676215,129797,234679158,877,485835,4657,611,35670,46349709,143560,36243287,-7,12,100,-34,-37,8,43.98,18.388889,12.327778,24.238889,0,13.705556,74.2788
7/20/2021,39877,58,887467,5716092,129855,235626272,938,486773,4750,618,39035,46388744,161279,36404566,-10,11,100,-36,-37,9,43.98,19.155556,12.111111,25.177778,0,14.277778,73.586137
7/21/2021,35548,55,1034621,5751640,129910,236707624,930,487703,4938,647,45101,46433845,183338,36587904,-9,10,96,-35,-37,9,43.98,19.45,14.455556,24.961111,0,15.166667,76.49001
7/22/2021,31278,78,1015937,5782918,129988,237843903,955,488658,5109,699,44036,46477881,188297,36776201,-9,11,105,-35,-38,9,43.98,18.688889,13.277778,24.122222,0,14.855556,78.879744
7/23/2021,27817,86,910023,5810735,130074,238841442,867,489525,5319,715,42974,46520855,189341,36965542,-11,8,93,-31,-38,8,43.98,17.855556,13.661111,22.066667,0.084667,13.166667,74.205433
7/24/2021,22852,74,753369,5833587,130148,239633451,828,490353,5386,755,43805,46564660,203886,37169428,-20,0,56,-25,-7,2,43.98,15.333333,11.866667,18.166667,0,11.133333,76.232259
7/25/2021,22187,73,792142,5855774,130221,240462383,939,491292,5655,779,24551,46589211,117956,37287384,-14,-2,68,-22,-3,1,43.98,15.394444,9.983333,19.583333,0,10.988889,75.166882
7/26/2021,29980,76,823325,5885754,130297,241355429,941,492233,6012,820,30019,46619230,148936,37436320,-4,8,118,-34,-42,9,43.98,16.644444,9.744444,22.527778,0,12.394444,76.279063
7/27/2021,29581,72,801954,5915335,130369,242252097,922,493155,6107,848,35402,46654632,151650,37587970,-8,6,84,-37,-41,10,43.98,15.972222,11.311111,20.083333,0.846667,12.755556,81.371397
7/28/2021,30237,88,903538,5945572,130457,243201104,852,494007,6116,853,43847,46698479,171173,37759143,-7,5,64,-38,-41,11,43.98,14.144444,11.388889,17.866667,5.418667,11.25,83.127887
7/29/2021,28432,83,864788,5974004,130540,244144118,840,494847,5996,869,42353,46740832,179918,37939061,-4,8,102,-35,-41,9,43.98,14.683333,11.294444,18.266667,2.032,11.691358,79.380969
7/30/2021,24749,108,839039,5998753,130648,245027154,746,495593,6028,889,36724,46777556,171096,38110157,-11,4,49,-33,-40,9,43.98,13.422222,11.461111,15.305556,0.677333,12.691358,92.368598
7/31/2021,20569,91,669556,6019322,130739,245729051,676,496269,5967,893,38826,46816382,212014,38322171,-17,0,52,-22,-7,1,43.98,14.033333,11.383333,16.561111,5.715,12.411111,90.153068
8/1/2021,20985,95,672220,6040307,130834,246432417,739,497008,5992,877,21232,46837614,118044,38440215,-9,-1,70,-20,-3,0,43.98,12.433333,7.933333,15.161111,1.467556,8.438889,76.78243
8/2/2021,29840,81,743471,6070147,130915,247234097,789,497797,6225,895,26092,46863706,126192,38566407,-1,7,110,-33,-43,9,43.98,13.066667,7.133333,18.105556,0,8.277778,72.947503
8/3/2021,30472,74,722566,6100619,130989,248059629,763,498560,6016,887,29290,46892996,142761,38709168,-3,7,119,-35,-42,9,43.98,13.544444,5.616667,19.872222,0,8.361111,71.327378
8/4/2021,32338,80,843810,6132957,131069,248941285,836,499396,5802,881,33334,46926330,165669,38874837,-3,7,113,-34,-41,9,43.98,14.711111,7.894444,20.316667,0,10.222222,74.578406
8/5/2021,31659,102,829750,6164616,131171,249828246,812,500208,5765,871,35500,46961830,172692,39047529,-7,6,74,-37,-42,10,43.98,15.788889,11.705556,19.755556,1.0795,11.705556,76.965315
8/6/2021,28036,95,793570,6192652,131266,250665379,781,500989,5762,870,36976,46998806,168356,39215885,-11,4,60,-33,-41,9,43.98,15.177778,13.172222,18.233333,4.064,13.516667,89.980967
8/7/2021,22540,95,653403,6215192,131361,251347922,729,501718,5713,854,37990,47036796,213583,39429468,-19,-2,34,-24,-9,2,43.98,13.95,11.716667,16.416667,9.355667,12.011111,88.36009
8/8/2021,22887,81,690941,6238079,131442,252067807,742,502460,5866,856,22843,47059639,122070,39551538,-13,-2,45,-22,-4,1,43.98,14.927778,12.061111,18.127778,5.164667,13.191358,86.539135
8/9/2021,32162,83,746853,6270241,131525,252898750,760,503220,6027,859,32250,47091889,137028,39688566,-3,6,88,-34,-42,9,43.98,14.377778,10.811111,17.566667,2.31775,10.883333,80.40975
8/10/2021,31518,81,749227,6301759,131606,253687994,894,504114,6030,874,37511,47129400,151143,39839709,-1,8,122,-33,-41,9,43.98,15.416667,11.105556,20.033333,0.381,11.838889,79.873529
8/11/2021,33349,89,839655,6335108,131695,254562563,850,504964,6015,871,41568,47170968,173761,40013470,-3,6,100,-34,-41,9,43.98,14.966667,10.077778,18.972222,0.338667,12.294444,84.407302
8/12/2021,31726,108,816020,6366834,131803,255452217,861,505825,5970,882,44384,47215352,192559,40206029,-2,8,111,-33,-41,9,43.98,14.55,8.605556,18.455556,1.552222,10.566667,77.605674
8/13/2021,28973,107,823257,6395807,131910,256323842,790,506615,5998,892,40490,47255842,171585,40377614,-8,6,90,-29,-40,8,43.98,14.838889,11.633333,17.761111,0.366889,10.133333,74.205989
8/14/2021,25057,96,649629,6420864,132006,256973471,788,507403,5895,892,46603,47302445,199584,40577198,-16,0,70,-18,-8,0,43.98,14.538889,11.216667,17.738889,0.084667,9.783333,73.714768
8/15/2021,25326,87,675523,6446190,132093,257649130,807,508210,6056,898,31257,47333702,126383,40703581,-9,0,75,-16,-3,0,43.98,13.461111,11.1,16.444444,1.143,11.216667,86.518593
8/16/2021,36906,83,720099,6483096,132176,258417590,870,509080,6393,918,35716,47369418,138390,40841971,-2,7,100,-32,-42,8,43.98,13.811111,11.094444,17.855556,0.4826,9.205556,74.299863
8/17/2021,37919,109,733234,6521015,132285,259223794,967,510047,6417,925,43824,47413242,145875,40987846,-5,6,87,-35,-42,9,43.98,15.061111,12.366667,17.816667,0.973667,12.2,83.386074
8/18/2021,38739,101,806967,6559754,132386,260085596,913,510960,6477,909,47284,47460526,169223,41157069,-3,6,95,-34,-39,9,43.98,14.911111,10.561111,18.422222,0,11.883333,82.609984
8/19/2021,36500,110,826979,6596254,132496,260977408,949,511909,6520,928,55979,47516505,175059,41332128,-5,7,98,-33,-40,9,43.98,14.183333,11.422222,17.533333,0.042333,11.583333,84.650091
8/20/2021,32231,118,766849,6628485,132614,261779880,872,512781,6532,955,60885,47577390,167392,41499520,-8,5,88,-29,-39,7,43.98,15.783333,12.094444,19.016667,0.725714,13.691358,84.621142
8/21/2021,28533,108,639328,6657018,132722,262433099,876,513657,6543,955,73006,47650396,194881,41694401,-18,-2,34,-22,-9,2,43.98,15.844444,14.755556,17.483333,1.439333,14.955556,94.521756
8/22/2021,28743,119,680215,6685761,132841,263140215,834,514491,6762,963,40345,47690741,116352,41810753,-10,-1,72,-17,-2,0,43.98,15.777778,13.411111,18.644444,9.11225,14.783951,91.101494
8/23/2021,39715,117,763404,6725476,132958,263951408,966,515457,7032,942,46401,47737142,131283,41942036,0,7,118,-31,-41,8,43.98,15.411111,11,19.638889,1.016,12.516667,82.934366
8/24/2021,37682,114,753489,6763158,133072,264783666,1000,516457,6974,957,55410,47792552,130676,42072712,-2,7,117,-32,-40,8,43.98,15.477778,10.483333,20.305556,0,12.444444,82.217176
8/25/2021,38777,103,931592,6801935,133175,265754477,1036,517493,6999,974,68076,47860628,161705,42234417,-1,8,109,-32,-40,8,43.98,15.238889,10.45,20.388889,0.036286,12.861111,85.805794
8/26/2021,37613,116,955124,6839548,133291,266784078,956,518449,7044,982,55140,47915768,144936,42379353,-1,9,109,-31,-40,8,43.98,13.222222,10.677778,15.511111,0.072571,9.905556,80.517763
8/27/2021,33743,129,895980,6873291,133420,267723894,945,519394,7098,988,44937,47960705,131456,42510809,-5,9,98,-26,-40,7,43.98,12.194444,9.094444,15.333333,0,9.183333,82.003724
8/28/2021,27599,126,697803,6900890,133546,268455323,864,520258,6993,953,43271,48003976,133688,42644497,-14,1,82,-15,-8,0,43.98,13.744444,6.5,20.2,0,9.361111,75.141927
8/29/2021,26135,128,711220,6927025,133674,269194912,857,521115,7123,971,24390,48028366,79440,42723937,-2,0,98,-12,-3,-1,43.98,12.388889,9.094444,15.211111,0.072571,10.261111,87.056457
8/30/2021,34773,107,692836,6961798,133781,269932003,997,522112,7352,984,19643,48048009,66648,42790585,1,-3,124,-41,-70,14,43.98,12.411111,10.627778,15.094444,0.296333,10.377778,87.607564
8/31/2021,45212,117,933480,7007010,133898,270954409,1003,523115,7691,1014,39899,48087908,119402,42909987,-3,12,72,-33,-40,9,43.98,12.072222,9.061111,15.466667,0.296333,9.755556,85.910182
9/1/2021,43532,120,1029454,7050542,134018,272047353,1084,524199,7695,1030,44088,48131996,113385,43023372,-4,9,69,-33,-36,9,43.98,12.811111,9.461111,15.85,0.217714,10.411111,85.511375
9/2/2021,42329,129,1161707,7092871,134147,273342705,999,525198,7635,1038,40002,48171998,119375,43142747,-5,9,77,-32,-35,8,43.98,13.566667,10.594444,17.266667,0.0635,10.694444,82.970336
9/3/2021,38630,148,1192010,7131501,134295,274637319,928,526126,7684,1034,35266,48207264,110590,43253337,-8,7,70,-27,-33,7,43.98,12.344444,10.761111,13.966667,0,9.866667,85.094632
9/4/2021,31810,135,746766,7163311,134430,275446062,952,527078,7569,1019,41054,48248318,128553,43381890,-13,2,59,-19,-5,1,43.98,12.82716,11.123457,14.685185,0.423333,10.401235,85.538017
9/5/2021,31803,157,1024203,7195114,134587,276524640,879,527957,7764,1018,21795,48270113,73193,43455083,-5,3,89,-15,-1,0,43.98,15.493827,11.407407,19.969136,0.108857,11.592593,77.901337
9/6/2021,44929,138,1372656,7240043,134725,278033671,1077,529034,8051,1062,22698,48292811,80015,43535098,-3,10,87,-27,-33,7,43.98,16.55,12.933333,20.744444,0.92075,14.111111,85.768162
9/7/2021,38619,156,1183116,7278662,134881,279401544,1101,530135,7993,1047,26624,48319435,85848,43620946,-6,10,98,-28,-32,7,43.98,17.833333,10.483333,25.066667,0.0508,14.127778,79.048816
9/8/2021,35849,142,1248402,7314511,135023,280808950,1167,531302,8149,1060,25131,48344566,87960,43708906,-6,9,83,-28,-31,7,43.98,19.616667,12.55,26.666667,0.0254,13.461111,67.777385
9/9/2021,33974,167,1234443,7348485,135190,282215362,1038,532340,8158,1051,25774,48370340,96702,43805608,-10,8,56,-29,-31,7,43.98,17.188889,13.533333,21.616667,0.592667,14.683333,85.355851
9/10/2021,29187,146,1072813,7377672,135336,283429523,925,533265,8329,1056,26064,48396404,91811,43897419,-10,7,54,-24,-29,6,41.2,17.211111,13.972222,20.644444,2.497667,15.444444,89.539634
9/11/2021,23533,138,722751,7401205,135474,284223362,851,534116,8157,1027,27913,48424317,98059,43995478,-12,3,61,-16,-5,1,41.2,15.772222,10.972222,18.533333,0.28575,12.533333,81.531086
9/12/2021,24060,144,1070797,7425265,135618,285340411,868,534984,8267,1055,14955,48439272,52615,44048093,-7,3,70,-16,-2,0,41.2,11.555556,8.105556,14.566667,0,8.866667,83.903091
9/13/2021,34658,110,1075606,7459923,135728,286567512,943,535927,8490,1056,19428,48458700,60653,44108746,-6,8,64,-26,-32,7,41.2,11.794444,8.211111,14.505556,0.310444,9.518519,83.2157
9/14/2021,31434,155,885413,7491357,135883,287573266,952,536879,8414,1060,17645,48476345,66725,44175471,-12,5,42,-29,-33,8,41.2,12.661111,10.655556,14.494444,0.4064,11.066667,90.199084
9/15/2021,30414,144,1134430,7521771,136027,288787027,953,537832,8422,1081,24402,48500747,63290,44238761,-6,9,67,-27,-31,7,41.2,13.761111,9.377778,18.516667,1.905,11.027778,83.602884
9/16/2021,29709,151,1044844,7551480,136178,289954683,894,538726,8140,1020,23051,48523798,63973,44302734,-7,8,79,-27,-32,6,41.2,14.183333,9.894444,18.711111,0,10.522222,78.932806
9/17/2021,29479,176,892753,7580959,136354,290915850,754,539480,7932,1011,20778,48544576,60384,44363118,-9,7,62,-24,-32,6,41.2,14.116667,9.161111,19.211111,0,11.044444,82.014643
9/18/2021,26645,124,693884,7607604,136478,291643544,759,540239,7721,1004,26198,48570774,72497,44435615,-12,2,65,-16,-7,0,41.2,15.105556,11.716667,19.011111,0,12.416667,84.561898
9/19/2021,31084,125,1122529,7638688,136603,292802760,731,540970,7772,1006,13840,48584614,35157,44470772,-9,1,49,-18,-5,1,41.2,14.155556,9.344444,17.838889,0.465667,11.588889,84.954767
9/20/2021,40768,139,1011761,7679456,136742,293980326,812,541782,7822,982,20150,48604764,46342,44517114,-6,8,70,-27,-33,6,41.2,12.5,5.994444,18.655556,0.366889,8.55,77.366749
9/21/2021,38848,122,899746,7718304,136864,294993358,808,542590,7649,943,20384,48625148,43406,44560520,-8,8,71,-28,-32,7,41.2,12.911111,7.466667,18.888889,0.028222,9.183333,78.673945
9/22/2021,36757,151,961488,7755061,137015,295999884,756,543346,7442,939,22679,48647827,44047,44604567,-7,7,61,-27,-29,7,41.2,14.727778,10.494444,18.422222,0.127,10.633333,77.026023
9/23/2021,35851,140,1060622,7790912,137155,297283009,783,544129,7196,916,25083,48672910,44588,44649155,-8,8,59,-28,-29,7,41.2,14.444444,12.661111,16.7,0.112889,11.211111,81.510117
9/24/2021,32109,126,899443,7823021,137281,298257276,731,544860,6945,878,27617,48700527,44759,44693914,-7,11,61,-22,-30,5,41.2,16.166667,12.944444,19.427778,0,13.294444,83.604295
9/25/2021,28567,125,777767,7851588,137406,299069112,678,545538,6991,874,24296,48724823,47118,44741032,-13,2,46,-14,-7,1,41.2,16.238889,13.072222,19.388889,0.09525,13.938889,86.616177
9/26/2021,32083,98,1126572,7883671,137504,300230149,672,546210,6854,839,15984,48740807,25539,44766571,-9,2,60,-13,-4,1,41.2,16.033333,12.994444,19.788889,0.03175,13.255556,83.964846
9/27/2021,41589,117,1031869,7925260,137621,301359564,782,546992,7085,831,24919,48765726,33177,44799748,-11,7,34,-27,-32,8,41.2,11.905556,7.566667,15.694444,2.286,8.877778,82.099978
9/28/2021,36547,109,866882,7961807,137730,302328714,783,547775,7067,826,31853,48797579,33532,44833280,-14,5,20,-29,-32,8,41.2,9.516667,6.544444,12.888889,9.779,8.055556,90.755708
9/29/2021,34836,126,1109689,7996643,137856,303496074,810,548585,6953,813,31539,48829118,34093,44867373,-10,7,35,-29,-31,7,41.2,8.638889,4.688889,12.577778,3.9116,5.316667,80.204945
9/30/2021,32605,113,1039273,8029248,137969,304663842,705,549290,6809,815,34372,48863490,34459,44901832,-11,6,15,-30,-31,8,41.2,10.788889,4.355556,15,0.762,9.422222,91.377319
10/1/2021,29058,129,873670,8058306,138098,305596880,699,549989,6642,805,38180,48901670,34289,44936121,-10,6,27,-26,-30,7,41.2,10.538889,6.677778,13.355556,7.946571,7.355556,81.228368
10/2/2021,26316,110,727074,8084622,138208,306310862,698,550687,6493,764,31066,48932736,34391,44970512,-18,-3,-13,-25,-10,3,41.2,8.494444,5.594444,10.35,3.132667,7.133333,91.280838
10/3/2021,32058,96,1024891,8116680,138304,307368387,722,551409,6650,778,24123,48956859,21532,44992044,-8,1,30,-19,-5,2,41.2,9.188889,5.038889,12.95,8.720667,6.966667,86.307675
10/4/2021,43734,103,967911,8160414,138407,308431072,814,552223,6841,769,37671,48994530,29337,45021381,-10,4,29,-30,-32,7,41.2,9.127778,6.472222,12.55,4.402667,7.211111,88.026784
10/5/2021,39278,120,853674,8199692,138527,309352710,839,553062,6915,800,41347,49035877,28572,45049953,-14,3,18,-32,-32,8,41.2,8.944444,7.333333,10.4,15.917333,7.816667,92.720029
10/6/2021,39264,104,1069330,8238956,138631,310482886,782,553844,6900,807,32828,49068705,28576,45078529,-9,5,38,-30,-30,7,41.2,9.966667,6.711111,13.9,17.562286,6.527778,79.605402
10/7/2021,38465,124,964013,8277421,138755,311560229,827,554671,6849,808,33029,49101734,28656,45107185,-10,5,35,-30,-30,7,41.2,14.644444,10.072222,18.116667,0.169333,13,90.097717
10/8/2021,35612,120,917700,8313033,138875,312536286,791,555462,6828,780,31685,49133419,29068,45136253,-10,5,37,-26,-29,6,41.2,14.511111,10.755556,18.527778,1.552222,12.05,85.430284
10/9/2021,32306,117,699340,8345339,138992,313265578,767,556229,6773,768,31395,49164814,33477,45169730,-11,1,37,-19,-7,1,41.2,13.655556,10.627778,15.75,0,12.783951,91.941172
10/10/2021,36418,96,967595,8381757,139088,314266853,735,556964,6944,744,22106,49186920,19451,45189181,-8,-1,48,-19,-5,1,41.2,10.494444,6.705556,13.85,0.310444,7.466667,82.095985
10/11/2021,50304,127,958592,8432061,139215,315326613,850,557814,7099,747,29172,49216092,23632,45212813,-8,5,45,-29,-31,7,46.76,10.116667,5.694444,13.85,0,7.122222,82.057088
10/12/2021,48321,115,878089,8480382,139330,316272145,946,558760,7129,780,36847,49252939,26946,45239759,-12,5,33,-30,-30,7,46.76,10.533333,8.455556,12.844444,0.127,8.783333,89.120168
10/13/2021,47773,121,1040268,8528155,139451,317374640,931,559691,7144,781,38726,49291665,29481,45269240,-10,4,33,-30,-30,7,46.76,11.122222,8.177778,14.011111,0.6985,9.033333,87.256563
10/14/2021,46420,149,979550,8574575,139600,318478424,915,560606,7202,783,43489,49335154,27991,45297231,-11,5,37,-30,-29,7,46.76,11.005556,7.116667,13.033333,0,8.088889,82.677085
10/15/2021,43560,139,910941,8618135,139739,319444965,958,561564,7215,791,40763,49375917,29432,45326663,-9,6,38,-26,-29,6,46.76,5.811111,1.511111,10.816667,1.2954,2.577778,79.997993
10/16/2021,37878,133,720933,8656013,139872,320199413,886,562450,7241,805,28999,49404916,33483,45360146,-12,0,26,-21,-8,2,46.76,6.561111,0.844444,10.283333,0.042333,5.488889,92.960052
10/17/2021,43753,129,982805,8699766,140001,321217930,974,563424,7513,819,17837,49422753,17265,45377411,-10,-2,29,-21,-6,2,46.76,12.183333,9.311111,14.544444,1.312333,11.155556,93.54677
10/18/2021,57743,127,935071,8757509,140128,322264759,1089,564513,7882,826,39672,49462425,23579,45400990,-11,3,22,-31,-32,8,46.76,12.811111,10.833333,14.5,0.790222,11.85,93.953055
10/19/2021,52529,129,879720,8810038,140257,323287166,1113,565626,8029,851,42902,49505327,32767,45433757,-13,3,21,-31,-31,8,46.76,14.711111,12.566667,17.594444,0.211667,13.932099,92.563323
10/20/2021,51661,155,1110011,8861699,140412,324443749,1113,566739,8284,872,49080,49554407,26365,45460122,-11,3,19,-31,-31,8,46.76,8.916667,4.822222,13.35,6.265333,6.925926,84.418488
10/21/2021,45193,157,1014189,8906892,140569,325567671,988,567727,8380,892,48732,49603139,26828,45486950,-9,6,37,-30,-30,7,46.76,5.611111,1.75,9.272222,3.664857,1.561111,75.743253
10/22/2021,40665,137,918293,8947557,140706,326533033,949,568676,8365,889,46250,49649389,26170,45513120,-10,5,29,-26,-31,7,46.76,8.161111,4.561111,11.044444,0.036286,5.033333,81.049627
10/23/2021,35103,165,702453,8982660,140871,327267380,915,569591,8359,869,40092,49689481,30243,45543363,-13,1,23,-19,-9,2,46.76,8.994444,4.727778,11.372222,0.1905,6.566667,85.068155
10/24/2021,35765,152,789098,9018425,141023,328088300,972,570563,8528,885,25747,49715228,18082,45561445,-9,-2,31,-19,-7,2,46.76,10.227778,8.188889,12.277778,0.471714,8.123457,84.050695
10/25/2021,47465,134,850618,9065890,141157,329034171,1066,571629,8850,913,37809,49753037,21446,45582891,-1,6,61,-30,-40,8,46.76,8.788889,5.255556,11.938889,2.413,6.845679,84.755996
10/26/2021,42124,165,820610,9108014,141322,329898346,1123,572752,8969,952,41083,49794120,23031,45605922,-4,6,50,-31,-39,9,46.76,11.477778,5.8,15.088889,0.254,9.493827,84.918911
10/27/2021,43045,162,918605,9151059,141484,330853986,1166,573918,9076,945,44082,49838202,21577,45627499,-2,5,46,-31,-39,9,46.76,14.394444,13.494444,15.427778,2.975429,11.938272,82.763026
10/28/2021,41391,192,874906,9192450,141676,331814730,1086,575004,9155,944,44702,49882904,23723,45651222,-2,7,49,-30,-39,8,46.76,13.305556,12.1,14.516667,14.689667,11.302469,85.219327
10/29/2021,40251,171,838082,9232701,141847,332696026,1032,576036,9254,962,40967,49923871,22279,45673501,-6,6,26,-28,-39,8,46.76,10.244444,6.855556,13.427778,7.916333,8.87037,88.32509
10/30/2021,33569,169,673065,9266270,142016,333402220,905,576941,9307,968,36052,49959923,25401,45698902,-12,3,14,-19,-10,1,46.76,7.894444,4.966667,10.616667,4.614333,6.407407,87.506338
10/31/2021,34814,188,954589,9301084,142204,334393091,1009,577950,9460,980,27402,49987325,13449,45712351,-13,1,-4,-21,-7,2,46.76,7.65,4.45,10.383333,5.418667,6.62963,90.52192
11/1/2021,45109,177,940568,9346193,142381,335418343,1099,579049,9706,1030,37695,50025020,19214,45731565,-10,4,17,-30,-31,8,46.76,7.45,3.833333,9.861111,12.482286,5.339506,83.677166
11/2/2021,38019,158,868460,9384212,142539,336339180,1084,580133,9688,1024,46663,50071683,20922,45752487,-10,6,24,-29,-29,7,46.76,5.366667,1.972222,9.972222,0.60325,4.246914,90.229138
11/3/2021,35986,165,1018582,9420198,142704,337398375,985,581118,9472,1019,41242,50112925,17965,45770452,-10,5,13,-30,-28,8,46.76,5.761111,2.877778,8.316667,0.60325,4.518519,88.719138
11/4/2021,33661,156,937020,9453859,142860,338422402,888,582006,9329,1034,43731,50156656,20482,45790934,-10,7,21,-29,-28,7,46.76,3.766667,-0.244444,7.044444,0.4064,0.788889,81.18298
11/5/2021,30318,160,827472,9484177,143020,339301013,861,582867,9128,1026,43491,50200147,22633,45813567,-10,7,34,-26,-28,7,46.76,6.122222,-0.972222,11.155556,0.056444,4.765432,89.641898
11/6/2021,27436,170,643592,9511613,143190,339974021,831,583698,8884,1018,36748,50236895,24500,45838067,-14,0,12,-21,-9,3,46.76,9.45679,7.024691,11.932099,0.084667,7.111111,82.104232
11/7/2021,30586,168,884418,9542199,143358,340888587,888,584586,8904,1012,25840,50262735,14610,45852677,-7,1,27,-18,-6,1,46.76,7.296296,3.833333,9.685185,1.42875,3.131944,71.901015
11/8/2021,44128,155,949400,9586327,143513,341919719,1015,585601,9054,1026,33559,50296294,20361,45873038,-10,5,17,-29,-29,7,46.76,7.883333,1.577778,12.005556,0,6.512346,88.967526
11/9/2021,42246,150,854921,9628573,143663,342824821,996,586597,9006,1023,39836,50336130,21199,45894237,-11,6,19,-30,-28,7,46.76,11.838889,8.461111,14.122222,0.508,10.148148,86.733216
11/10/2021,42942,149,1022224,9671515,143812,343885877,989,587586,8935,1008,119188,50455318,47766,45942003,-11,5,9,-30,-27,8,46.76,8.461111,5.827778,10.755556,1.0922,6.808642,86.205674
11/11/2021,40999,145,985309,9712514,143957,344962457,965,588551,8783,999,36383,50491701,22485,45964488,-10,6,21,-29,-27,7,46.76,8.277778,3.894444,11.011111,0.09525,6.820988,87.833617
11/12/2021,37765,149,834464,9750279,144106,345843488,892,589443,8691,989,34338,50526039,22048,45986536,-11,5,6,-27,-28,7,46.76,10.111111,8.638889,11.377778,1.524,8.851852,89.195164
11/13/2021,32883,135,657543,9783162,144241,346532250,779,590222,8555,974,33527,50559566,24325,46010861,-11,2,16,-20,-8,2,46.76,9.311111,6.75,11.333333,2.3622,7.259259,84.29019
11/14/2021,35530,129,920463,9818692,144370,347481461,808,591030,8642,979,22938,50582504,17048,46027909,-7,1,27,-18,-6,1,46.76,8.544444,5.183333,10.883333,0,7.462963,90.269022
11/15/2021,50949,174,940879,9869641,144544,348501219,838,591868,8799,968,32046,50614550,18055,46045964,-9,6,18,-29,-29,7,46.76,8.127778,5.572222,9.577778,0,7.716049,94.93189
11/16/2021,46429,153,814260,9916070,144697,349378665,906,592774,8523,938,31431,50645981,19874,46065838,-11,5,14,-29,-28,7,46.76,8.266667,5.311111,9.944444,0.544286,6.962963,88.613474
11/17/2021,45894,126,1038145,9961964,144823,350515525,867,593641,8274,935,33092,50679073,22120,46087958,-9,5,16,-29,-27,7,46.76,7.427778,3.933333,9.694444,0.508,5.12963,82.58271
11/18/2021,44061,136,995676,10006025,144959,351575322,843,594484,8175,923,28880,50707953,20650,46108608,-9,7,18,-29,-27,7,46.76,11.788889,8.605556,13.183333,0.15875,9.790123,84.823353
11/19/2021,39608,124,867675,10045633,145083,352490226,775,595259,8123,911,27084,50735037,21607,46130215,-8,7,19,-25,-27,7,46.76,10.844444,8.744444,12.511111,0.112889,8.41358,82.113681
11/20/2021,35335,130,712358,10080968,145213,353231300,735,595994,8003,908,26013,50761050,24193,46154408,-10,1,11,-18,-8,2,46.76,8.555556,4.227778,11.327778,0.056444,6.018519,81.396055
11/21/2021,37252,106,1010643,10118220,145319,354340119,758,596752,8098,913,16424,50777474,13892,46168300,-6,0,20,-18,-6,1,46.76,3.244444,1.288889,5.738889,0.084667,0.844444,84.519354
11/22/2021,50733,120,1001502,10168953,145439,355420826,743,597495,8194,928,23258,50800732,18517,46186817,-8,6,18,-29,-29,7,46.76,3.177778,-0.3,6.966667,0.536222,1.416667,88.334866
11/23/2021,48197,143,913448,10217150,145582,356457390,786,598281,7980,919,26822,50827554,22002,46208819,-10,6,15,-29,-28,7,46.76,4.438889,0.572222,7.783333,0.056444,3.432099,91.339468
11/24/2021,46771,116,1077904,10263921,145698,357580328,909,599190,7731,928,24579,50852133,23439,46232258,-9,5,8,-29,-27,8,46.76,4.366667,-0.255556,8.222222,0.028222,2.753086,86.745473
11/25/2021,43424,136,1050515,10307345,145834,358723895,776,599966,7722,925,23579,50875712,22823,46255081,-6,8,17,-28,-27,7,46.76,1.627778,-1.883333,4.433333,0.34925,-0.91358,80.930972
11/26/2021,39329,132,886114,10346674,145966,359656486,734,600700,7623,925,20314,50896026,23665,46278746,-7,6,0,-26,-29,7,46.76,4.122222,0.155556,6.933333,2.455333,1.227778,81.637915
11/27/2021,33300,108,720113,10379974,146074,360407219,717,601417,7470,911,23808,50919834,32866,46311612,-16,-3,-20,-26,-10,4,46.76,0.955556,-1.477778,2.955556,18.076333,-1.722222,82.52717
11/28/2021,39704,120,1017750,10419678,146194,361457828,715,602132,7501,919,21493,50941327,29445,46341057,-8,0,3,-20,-6,2,46.76,-1.2,-3.738889,0.772222,0.870857,-3.455556,84.942181
11/29/2021,56290,124,1040782,10475968,146318,362580755,809,602941,7732,916,22391,50963718,26092,46367149,-7,6,4,-31,-30,8,46.76,0.872222,-4.666667,8.083333,0.056444,-0.655556,89.624885
11/30/2021,55694,96,1010590,10531662,146414,363694272,841,603782,7743,931,30539,50994257,32157,46399306,-7,10,5,-30,-28,8,46.76,9.177778,5.272222,10.694444,0.762,7.876543,88.918785
12/1/2021,54819,124,1185982,10586481,146538,364928232,828,604610,7415,895,26028,51020285,32356,46431662,-8,6,0,-30,-28,8,46.76,3.861111,0.161111,7.861111,8.678333,1.088889,82.268028
12/2/2021,50320,108,1135522,10636801,146646,366164439,841,605451,7486,895,25848,51046133,30976,46462638,-7,7,11,-30,-27,8,46.76,0.327778,-1.411111,2.566667,1.185333,-3.25,77.408779
12/3/2021,45667,133,1066986,10682468,146779,367282001,736,606187,7395,900,23264,51069397,29811,46492449,-7,6,5,-26,-28,7,46.76,4.311111,0.016667,6.527778,0.290286,2.75,89.688248
12/4/2021,38782,147,866910,10721250,146926,368213727,751,606938,7250,895,26914,51096311,37798,46530247,-12,-1,-4,-20,-8,3,46.76,3.455556,1.216667,6.022222,2.286,1.833333,89.288626
12/5/2021,41051,112,1132009,10762301,147038,369385026,845,607783,7353,882,21955,51118266,27166,46557413,-7,0,-1,-20,-5,2,46.76,3.854167,1.354167,5.208333,12.7508,2.479167,90.792346
12/6/2021,59692,137,1137478,10821993,147175,370607005,871,608654,7462,901,19979,51138245,25012,46582425,-8,6,-4,-32,-30,8,46.76,2.462963,0.592593,4.666667,2.6924,1.32716,92.23024
12/7/2021,56252,122,1063146,10878245,147297,371768638,946,609600,7447,880,23512,51161757,28375,46610800,-14,2,-12,-34,-28,9,46.76,2.944444,0.117284,5.246914,2.8448,1.141975,87.994659
12/8/2021,58825,113,1286150,10937070,147410,373117102,888,610488,7466,890,21700,51183457,29437,46640237,-8,6,-4,-32,-26,8,46.76,4.123457,2.648148,5.611111,3.767667,2.438272,88.850476
12/9/2021,56994,125,1317690,10994064,147535,374535525,953,611441,7535,900,24039,51207496,33824,46674061,-5,9,10,-30,-26,7,46.76,3.493827,-0.296296,6.833333,1.524,2.092593,90.610031
12/10/2021,52491,109,1198855,11046555,147644,375791269,831,612272,7489,901,22063,51229559,31962,46706023,-6,7,5,-26,-26,7,46.76,3.012346,-0.722222,5.623457,1.49225,0.425926,83.433947
12/11/2021,48594,96,1000539,11095149,147740,376834925,793,613065,7455,883,26291,51255850,38984,46745007,-12,1,-10,-20,-5,2,46.76,4.345679,-0.987654,9.567901,0.0508,3.506173,94.320511
12/12/2021,53157,122,1256352,11148306,147862,378091303,869,613934,7578,893,23317,51279167,30195,46775202,-7,1,5,-20,-2,2,46.76,9.432099,5.901235,11.839506,1.55575,8.08642,91.363577
12/13/2021,87170,104,1349348,11235476,147966,379531607,929,614863,7798,900,19671,51298838,29407,46804609,-4,11,6,-33,-30,8,46.76,6.95679,3.58642,10.808642,1.850571,5.117284,88.166064
12/14/2021,102786,128,1326539,11338262,148094,380945652,957,615820,7798,896,34082,51332920,37888,46842497,-6,12,8,-34,-29,9,46.76,6.179012,2.524691,8.623457,0.705556,4.376543,88.360448
12/15/2021,112699,113,1640506,11450961,148207,382659706,954,616774,7723,888,28067,51360987,38794,46881291,-2,13,8,-33,-29,9,43.98,8.65,6.272222,10.366667,0,6.605556,87.292186
12/16/2021,106048,107,1609826,11557009,148314,384381445,924,617698,7744,875,32677,51393664,42497,46923788,-3,14,14,-34,-30,9,43.98,5.15,1.366667,8.55,0,4.305556,94.362777
12/17/2021,95879,129,1575050,11652888,148443,386029961,881,618579,7622,879,32890,51426554,42286,46966074,-6,10,7,-32,-30,9,43.98,1.777778,-2.08642,7.709877,0.056444,1.197531,95.935497
12/18/2021,88883,108,1396458,11741771,148551,387483337,840,619419,7558,855,38329,51464883,45898,47011972,-14,4,-4,-26,-6,3,43.98,3.216049,0.141975,6.259259,0.15875,2.722222,96.648322
12/19/2021,89129,103,1457324,11830900,148654,389037378,1018,620437,7715,858,33151,51498034,39904,47051876,-8,3,0,-25,-1,2,43.98,3.37037,0.123457,5.95679,0.22225,1.993827,92.33342
12/20/2021,133966,124,1522487,11964866,148778,390640143,1224,621661,7959,859,39793,51537827,50938,47102814,5,19,14,-37,-41,10,43.98,3.438272,1.506173,4.864198,0.41275,1.888889,89.716147
12/21/2021,150292,101,1510031,12115158,148879,392249465,1265,622926,8175,849,39955,51577782,54085,47156899,2,22,15,-39,-42,11,43.98,1.895062,0.54321,3.450617,0.056444,-0.679012,83.167716
12/22/2021,161561,126,1663545,12276719,149005,393990015,1418,624344,8397,842,39309,51617091,53154,47210053,4,29,5,-39,-44,11,45.83,1.290123,-1.425926,3.388889,0,-0.858025,86.199621
12/23/2021,160634,132,1630536,12437353,149137,395749681,1409,625753,8425,843,32605,51649696,44046,47254099,7,42,8,-39,-50,12,45.83,5.209877,1.907407,7.932099,0.973667,4.777778,97.054047
12/24/2021,137268,126,1604482,12574621,149263,397423002,1200,626953,8669,832,10770,51660466,13968,47268067,-17,20,-4,-49,-62,16,45.83,5.024691,2.598765,7.302469,1.905,3.944444,92.795778
12/25/2021,70362,108,1158898,12644983,149371,398631199,1420,628373,8470,838,955,51661421,917,47268984,-87,-88,-49,-81,-64,11,45.83,2,0.694444,3.5,1.052286,-1.486111,78.239197
12/26/2021,116275,117,1270902,12761258,149488,399986274,1547,629920,8888,851,1935,51663356,2084,47271068,-48,-50,-16,-55,-35,4,48.61,2.740741,0.654321,4.154321,1.735667,1.67284,92.750855
12/27/2021,195007,144,1317586,12956265,149632,401376024,1974,631894,9910,870,18191,51681547,23706,47294774,-15,-17,11,-54,-78,18,48.61,4.790123,3.018519,6.506173,3.386667,4.382716,97.253806
12/28/2021,212463,167,1491353,13168728,149799,402932171,2315,634209,11072,851,23859,51705406,29534,47324308,-14,-9,18,-54,-76,20,48.61,6.493827,3.376543,7.845679,1.566333,5.895062,95.990016
12/29/2021,272790,126,1515737,13441518,149925,404519256,2635,636844,12117,868,32607,51738013,43766,47368074,-11,2,5,-50,-65,18,48.61,6.9375,1.25,10.986111,1.693333,5.222222,89.050647
12/30/2021,236573,191,1530435,13678091,150116,406169402,2403,639247,13309,875,33371,51771384,44107,47412181,-11,8,20,-49,-64,18,48.61,11.253086,8.685185,12.746914,4.953,9.765432,90.733629
12/31/2021,188564,169,1731869,13866655,150285,407981020,2107,641354,14342,883,15384,51786768,22070,47434251,-20,9,22,-51,-64,17,48.61,11.611111,9.987654,12.58642,12.954,9.62963,87.946884
1/1/2022,118269,182,1054753,13984924,150467,409102602,2077,643431,14672,857,2277,51789045,2758,47437009,-63,-54,3,-59,-49,11,48.61,11.117284,9.283951,13.104938,0.395111,6.790123,76.602805
1/2/2022,181065,177,1359060,14165989,150644,410520532,2118,645549,15307,864,12449,51801494,16485,47453494,-25,-12,0,-39,-15,6,48.61,8.481481,6.839506,10.123457,3.447143,6.263889,82.749553
1/3/2022,229896,179,1721767,14395885,150823,412315619,2480,648029,16500,878,19158,51820652,29295,47482789,-15,-8,32,-56,-74,21,48.61,6.283951,0.358025,8.654321,4.953,3.061728,79.948815
1/4/2022,275647,220,2061041,14671532,151043,414532832,2402,650431,17493,900,24866,51845518,40887,47523676,-25,0,-5,-48,-42,15,46.76,-0.259259,-3.04321,1.975309,4.826,-2.820988,83.255649
1/5/2022,222170,214,2058093,14893702,151257,416766097,2407,652838,18215,875,29030,51874548,41664,47565340,-25,-1,0,-46,-36,14,46.76,0.530864,-4.024691,3.191358,0.028222,-2.845679,78.582842
1/6/2022,172980,258,1799011,15066682,151515,418837156,2345,655183,18692,868,22741,51897289,34688,47600028,-30,-4,-14,-47,-35,14,46.76,0.209877,-5.561728,4.006173,0.042333,-1.524691,88.265684
1/7/2022,120288,251,1588137,15186970,151766,420609308,2046,657229,18873,840,23422,51920711,35627,47635655,-28,-4,-13,-44,-32,13,46.76,0.987654,-1.839506,3.506173,2.721429,-1.04321,86.52086
1/8/2022,93612,245,1314078,15280582,152011,421998975,2100,659329,18809,820,31689,51952400,51715,47687370,-32,-9,-36,-44,-12,8,46.76,3.160494,-1.555556,6.691358,2.455333,1.716049,90.253952
1/9/2022,95788,272,1634426,15376370,152283,423704813,2217,661546,19251,816,22205,51974605,31360,47718730,-22,-7,13,-36,-6,5,46.76,3.703704,0.635802,6.098765,3.338286,1.765432,87.248237
1/10/2022,132955,279,1620875,15509325,152562,425534718,2458,664004,20057,821,17954,51992559,26728,47745458,-22,-2,-1,-42,-31,11,46.76,5.722222,3.228395,7.722222,0.395111,4.944444,92.177931
1/11/2022,115244,270,1407849,15624569,152832,427066281,2422,666426,19959,793,19276,52011835,28790,47774248,-23,-2,1,-42,-31,11,46.76,3.761111,-0.35,7.25,0.41275,2.734568,90.893506
1/12/2022,103221,262,1572177,15727790,153094,428735668,2204,668630,19933,785,19520,52031355,30340,47804588,-21,-1,10,-41,-30,11,46.76,5.344444,0.538889,9.022222,0.036286,4.253086,90.446548
1/13/2022,96412,285,1409318,15824202,153379,430278990,2162,670792,19769,777,20521,52051876,32197,47836785,-22,0,13,-41,-30,11,46.76,4.627778,1.205556,7.933333,0.0254,2.580247,84.054422
1/14/2022,86325,281,1257257,15910527,153660,431616373,1941,672733,19554,746,20878,52072754,31182,47867967,-21,0,7,-38,-28,10,46.76,2.738889,-1.311111,6.355556,0.028222,1.641975,93.161714
1/15/2022,77948,297,1071093,15988475,153957,432745047,1789,674522,19308,712,27409,52100163,58050,47926017,-22,-5,-4,-35,-8,5,46.76,0.738889,-1.755556,3.022222,0,0.022222,95.116173
1/16/2022,98094,295,1275520,16086569,154252,434102531,1942,676464,19432,715,17700,52117863,37116,47963133,-19,-6,18,-33,-5,3,46.76,2.916667,-0.461111,6.388889,0.108857,1.594444,91.20491
1/17/2022,131514,296,1382747,16218083,154548,435603681,2027,678491,19667,713,15748,52133611,26502,47989635,-19,-1,17,-39,-30,9,46.76,2.633333,-1.222222,7.6,0.141111,0.877778,88.427175
1/18/2022,118857,290,1313770,16336940,154838,437056598,2015,680506,19230,703,18032,52151643,29434,48019069,-22,-2,8,-38,-30,10,46.76,1.988889,-2.216667,5.394444,0.028222,0.572222,90.464261
1/19/2022,111758,281,1535657,16448698,155119,438671516,1991,682497,18734,675,16949,52168592,29893,48048962,-20,-1,5,-38,-29,10,46.76,5.155556,1.05,8.2,0.79375,2.338889,82.409693
1/20/2022,100325,254,1371887,16549023,155373,440162425,1913,684410,18223,664,17806,52186398,33674,48082636,-19,0,13,-37,-29,10,46.76,1.177778,-2.294444,4.288889,0.1016,-2.883333,74.915411
1/21/2022,91730,304,1220379,16640753,155677,441457617,1675,686085,17783,640,17532,52203930,34034,48116670,-19,0,4,-35,-27,9,46.76,2.472222,-2.877778,6.777778,0,0.633333,87.851461
1/22/2022,81733,286,1038336,16722486,155963,442554913,1439,687524,17151,625,20378,52224308,47765,48164435,-19,-4,4,-30,-7,4,46.76,3.938889,0.1,7.077778,0.028222,2.522222,90.604092
1/23/2022,102364,255,1228669,16824850,156218,443851257,1690,689214,17118,603,12266,52236574,30710,48195145,-19,-7,11,-30,-5,3,46.76,3.75,0.6,5.9,0.028222,1.988889,88.413662
1/24/2022,127364,281,1355027,16952214,156499,445320093,1785,690999,17400,598,16005,52252579,29833,48224978,-18,-2,9,-36,-29,9,46.76,3.155556,-0.483333,6.005556,0.0254,1.855556,91.283984
1/25/2022,113201,247,1275404,17065415,156746,446678099,1901,692900,16817,575,13936,52266515,28788,48253766,-20,-1,6,-36,-29,9,46.76,1.905556,-0.933333,4.044444,0,0.961111,93.494881
1/26/2022,108668,264,1442328,17174083,157010,448195530,1881,694781,16739,561,15358,52281873,30919,48284685,-17,-1,8,-36,-29,9,46.76,5.177778,0.227778,8.516667,0.03175,3.266667,87.689571
1/27/2022,96202,300,1286463,17270285,157310,449591133,1684,696465,16399,549,15706,52297579,29948,48314633,-17,1,15,-35,-28,9,42.13,6.511111,1.111111,9.533333,0.85725,3.288889,80.350108
1/28/2022,84026,261,1160207,17354311,157571,450884589,1529,697994,16174,535,16949,52314528,33935,48348568,-15,1,7,-32,-27,9,42.13,5.294444,-0.222222,9.561111,0.028222,3.755556,89.959771
1/29/2022,73505,262,923854,17427816,157833,451863725,1451,699445,15302,527,18946,52333474,40329,48388897,-16,-4,1,-27,-7,4,42.13,7.944444,2.405556,11.35,0.09525,3.361111,73.424134
1/30/2022,87698,245,1128984,17515514,158078,453103828,1426,700871,15588,520,11684,52345158,27601,48416498,-12,-5,27,-26,-4,2,42.13,3.205556,-0.944444,6.661111,0.042333,0.588889,83.27105
1/31/2022,105047,257,1236640,17620561,158335,454478363,1663,702534,15944,511,15329,52360487,24275,48440773,-15,0,9,-34,-29,8,42.13,3.944444,1.222222,6.477778,3.011714,-0.85,71.673964
2/1/2022,93949,264,1187284,17714510,158599,455743684,1771,704305,15496,502,12735,52373222,26367,48467140,-16,1,14,-33,-28,8,42.13,8.638889,4.583333,10.461111,0.028222,4.65,76.629011
2/2/2022,88417,248,1337656,17802927,158847,457150578,1661,705966,15106,483,12466,52385688,27274,48494414,-15,1,12,-32,-27,9,42.13,8.533333,5.972222,10.377778,0.366889,6.605556,88.00523
2/3/2022,76642,232,1222608,17879569,159079,458495884,1497,707463,14919,478,13343,52399031,26099,48520513,-15,2,14,-33,-27,8,42.13,7.872222,5.405556,9.172222,0.084667,5.55,85.644994
2/4/2022,63264,195,1064207,17942833,159274,459628341,1421,708884,14488,474,15151,52414182,29181,48549694,-16,1,1,-31,-26,8,42.13,2.877778,1,6.444444,1.161143,-0.033333,81.655219
2/5/2022,52304,218,845042,17995137,159492,460522871,1246,710130,14009,458,14794,52428976,28195,48577889,-17,-5,-7,-26,-8,4,42.13,5.216667,1.455556,7.716667,1.27,2.877778,85.215954
2/6/2022,60547,213,1007469,18055684,159705,461587520,1352,711482,13908,441,8321,52437297,16605,48594494,-17,-7,-9,-28,-5,3,42.13,3.35,0.394444,6.094444,10.287,0.588889,82.632682
2/7/2022,76483,180,1141695,18132167,159885,462875310,1434,712916,14102,443,10106,52447403,22861,48617355,-15,1,15,-32,-28,8,42.13,4.427778,-1.95,9.494444,2.8575,1.822222,83.553487
2/8/2022,69661,190,1078195,18201828,160075,464021331,1479,714395,13853,430,10804,52458207,24721,48642076,-15,1,16,-31,-28,8,42.13,8.377778,6.744444,10.433333,0.254,6.438889,87.854813
2/9/2022,64339,181,1176413,18266167,160256,467339805,1425,715820,13416,432,10523,52468730,24725,48666801,-14,1,13,-31,-27,8,42.13,5.161111,2.211111,7.85,1.36525,1.377778,77.065026
2/10/2022,52292,183,1045891,18318459,160439,468481112,1346,717166,13023,430,11614,52480344,26290,48693091,-14,3,15,-30,-27,8,42.13,3.016667,-0.338889,5.772222,0.1778,-0.527778,78.091327
2/11/2022,44557,164,924488,18363016,160603,469465023,1187,718353,12603,416,11075,52491419,25884,48718975,-12,4,18,-27,-26,7,39.35,1.027778,-5.061111,5.222222,0.028222,-1.872222,81.210154
2/12/2022,37527,165,723602,18400543,160768,470229402,1149,719502,12265,400,15181,52506600,26309,48745284,-16,-2,-2,-24,-8,3,39.35,5.627778,2.466667,7.794444,1.886857,2.927778,83.302126
2/13/2022,41755,175,784949,18442298,160943,471058590,1188,720690,12317,384,7494,52514094,13623,48758907,-16,-4,-21,-26,-6,3,39.35,6.861111,5.272222,8.033333,7.112,5.633333,91.962983
2/14/2022,54746,192,903293,18497044,161135,472031203,1353,722043,12550,393,8107,52522201,18172,48777079,-4,9,19,-31,-33,8,39.35,4.85,2.527778,7.061111,10.033,2.816667,86.942706
2/15/2022,52501,174,891198,18549545,161309,472991060,1371,723414,12347,354,9091,52531292,19482,48796561,-15,-2,4,-33,-33,8,32.41,4.322222,0.561111,7.255556,5.334,1.727778,83.58075
2/16/2022,51570,168,977558,18601115,161477,474017352,1375,724789,12010,359,10914,52542206,21914,48818475,-14,-1,5,-33,-32,9,32.41,8.655556,4.277778,11.716667,5.122333,5.555556,81.226126
2/17/2022,44716,163,906915,18645831,161640,475006823,1187,725976,11859,330,9254,52551460,21378,48839853,-10,5,24,-30,-31,8,32.41,4.15,1.266667,6.827778,5.0165,0.222222,76.187314
2/18/2022,33239,159,707876,18679070,161799,475759159,1102,727078,11487,335,5886,52557346,14700,48854553,-32,-15,-27,-46,-39,14,32.41,2.894444,0.483333,5.738889,5.164667,0.911111,87.017619
2/19/2022,34648,157,577649,18713718,161956,476367388,1014,728092,11507,328,10773,52568119,20776,48875329,-21,-4,-17,-28,-9,4,32.41,2.088889,-0.1,4.383333,5.715,-0.133333,85.428832
2/20/2022,37717,167,708132,18751435,162123,477111496,1137,729229,11431,334,5470,52573589,10564,48885893,-22,-10,-26,-30,-7,3,32.41,6.493827,0.5,10.858025,11.387667,4.067901,84.555348
2/21/2022,45127,146,834143,18796562,162269,478006868,1242,730471,11624,324,7411,52581000,16008,48901901,-13,1,16,-34,-34,9,32.41,5.627778,0.816667,9.433333,20.023667,1.772222,76.45252
2/22/2022,39186,144,739443,18835748,162413,478788460,1176,731647,11336,312,8291,52589291,17904,48919805,-11,2,23,-30,-32,8,32.41,6.022222,2.311111,9.088889,1.100667,2.661111,79.347255
2/23/2022,36476,146,760441,18872224,162559,479585592,1244,732891,11291,304,8985,52598276,17951,48937756,-10,1,19,-31,-32,8,32.41,6.261111,2.822222,8.794444,3.640667,2.522222,77.400305
2/24/2022,30631,166,690010,18902855,162725,480370538,1226,734117,11000,289,7963,52606239,15838,48953594,-13,0,10,-32,-32,8,32.41,2.522222,0.544444,4.927778,2.921,-1.1,77.462618
2/25/2022,27833,148,615874,18930688,162873,481020476,1109,735226,10867,271,8109,52614348,16370,48969964,-9,4,31,-27,-31,7,32.41,4.25,0.672222,8.055556,1.2954,0.244444,75.705856
2/26/2022,25086,134,492118,18955774,163007,481512594,1084,736310,10590,255,9471,52623819,19652,48989616,-12,-2,20,-20,-7,1,32.41,5.177778,1.855556,8.55,0,1.685185,75.472889
2/27/2022,31360,136,535313,18987134,163143,482047986,1102,737412,10745,271,4841,52628660,10606,49000222,-8,-2,42,-17,-3,0,32.41,4.25,0.772222,7.977778,0,-0.844444,69.806546
2/28/2022,44641,145,709674,19031775,163288,482805930,1401,738813,10973,290,5788,52634448,14302,49014524,-14,3,5,-31,-28,7,23.15,5.594444,2,8.711111,0.381,4.351852,89.018917
3/1/2022,44788,135,653860,19076563,163423,483531510,1367,740180,10936,278,5810,52640258,15004,49029528,-17,5,12,-32,-27,7,23.15,2.333333,-2.627778,8.088889,3.302,-0.2,83.437536
3/2/2022,46174,161,703159,19122737,163584,484271455,1459,741639,10864,279,7448,52647706,14410,49043938,-17,0,-6,-32,-26,8,23.15,3.972222,-0.377778,5.238889,0.211667,2.705556,91.496495
3/3/2022,43761,160,667217,19166498,163744,485065522,1477,743116,10722,264,6347,52654053,17629,49061567,-16,3,12,-34,-27,7,23.15,5.55,4.022222,7.3,2.413,4.111111,88.104246
3/4/2022,41407,132,630426,19207905,163876,485736856,1370,744486,10920,257,6688,52660741,16561,49078128,-14,2,7,-30,-25,7,23.15,4.033333,2.127778,5.566667,9.567333,2.894444,92.343261
3/5/2022,38753,126,505253,19246658,164002,486242109,1245,745731,10917,256,8168,52668909,18808,49096936,-14,-2,6,-24,-7,2,23.15,3.333333,0.683333,6.572222,1.42875,0.322222,80.93194
3/6/2022,49023,131,529677,19295681,164133,486771809,1456,747187,11063,263,4059,52672968,9894,49106830,-11,-3,25,-22,-4,1,23.15,2.677778,-1.627778,7.85,0.395111,-0.222222,81.423811
3/7/2022,68521,147,728433,19364202,164280,487547668,1534,748721,11539,269,4596,52677564,13522,49120352,-15,1,18,-32,-27,7,23.15,0.905556,-4.888889,5.872222,0.0762,-1.694444,82.877549
3/8/2022,70107,147,714301,19434309,164427,488331255,1699,750420,11862,275,4564,52682128,14655,49135007,-16,2,17,-32,-26,6,23.15,4.283333,-0.111111,8.3,0.0254,-0.916667,69.263162
3/9/2022,73529,141,745484,19507838,164568,489116841,1832,752252,11980,266,5196,52687324,15331,49150338,-17,0,8,-33,-26,7,23.15,7.527778,3.822222,11.15,0,3.161111,74.27635
3/10/2022,70503,154,730205,19578341,164722,489909822,1721,753973,12177,253,4765,52692089,14282,49164620,-16,2,21,-32,-25,7,23.15,9.216667,6.444444,12.422222,0.7366,5.311111,77.058834
3/11/2022,67029,142,696949,19645370,164864,490648384,1739,755712,12353,254,4438,52696527,14366,49178986,-19,-1,-1,-32,-26,7,23.15,9.127778,6.627778,11.616667,0.169333,5.805556,80.025973
3/12/2022,62068,144,570068,19707438,165008,491218452,1629,757341,12665,252,8047,52704574,19735,49198721,-17,-3,9,-26,-7,2,23.15,7.794444,6.055556,10.622222,4.148667,4.116667,78.02885
3/13/2022,75729,154,600618,19783167,165162,491826648,1829,759170,13042,257,3851,52708425,10520,49209241,-16,-5,9,-24,-5,1,23.15,7.75,5.155556,10.938889,0.973667,4.066667,77.912339
3/14/2022,99833,181,783005,19883000,165343,492666384,1991,761161,13793,280,4763,52713188,16929,49226170,-16,1,25,-32,-27,7,23.15,6.227778,2.1,10.233333,0.580571,2.822222,79.520897
3/15/2022,93703,154,787563,19976703,165497,493557578,2152,763313,14317,281,4262,52717450,14579,49240749,-17,0,24,-32,-26,7,23.15,6.883333,1.544444,11.672222,0.6858,3.122222,77.366417
3/16/2022,91754,184,838519,20068457,165681,494442488,2139,765452,14487,281,4009,52721459,14046,49254795,-20,-3,-4,-34,-26,8,23.15,6.227778,3.361111,8.822222,0,4.477778,88.690438
3/17/2022,82849,187,765678,20151306,165868,495304892,2087,767539,14935,292,4201,52725660,14729,49269524,-13,2,31,-31,-27,7,23.15,5.666667,-0.172222,10.655556,2.822222,2.644444,81.361779
3/18/2022,75283,208,737174,20226589,166076,496092500,1964,769503,15171,287,4343,52730003,14641,49284165,-14,1,38,-29,-27,6,20.37,6.133333,-1.4,12.972222,0.4318,2.122222,75.585143
3/19/2022,67412,195,601004,20294001,166271,496693504,2061,771564,15245,277,10237,52740240,19104,49303269,-16,-3,36,-23,-9,1,20.37,6.533333,0.833333,12.783333,0.0254,1.727778,71.867145
3/20/2022,81049,201,609563,20375050,166472,497303169,2038,773602,15703,280,7006,52747246,9708,49312977,-12,-3,42,-20,-6,0,20.37,4.411111,0.005556,9.127778,0.0254,0.383333,75.329454
3/21/2022,109281,185,808175,20484331,166657,498172678,2283,775885,16498,299,4505,52751751,12060,49325037,-15,2,31,-32,-27,7,20.37,4.383333,-2.994444,10.805556,0,0.055556,73.570408
3/22/2022,99094,225,803232,20583425,166882,499052785,2430,778315,16917,316,4631,52756382,11840,49336877,-16,2,42,-31,-26,6,20.37,9.305556,3.305556,15.944444,0.0254,4.227778,70.702703
3/23/2022,94176,209,818369,20677601,167091,499914588,2501,780816,17154,302,-2263,52754119,4283,49341160,-13,2,43,-31,-26,6,20.37,9.3,2.494444,16.977778,0,3.838889,68.996523
3/24/2022,82897,216,741482,20760498,167307,500743859,2359,783175,17629,330,5094,52759213,11725,49352885,-12,5,48,-30,-26,6,20.37,9.222222,1.805556,16.15,0,3.505556,67.499042
3/25/2022,72430,227,711313,20832928,167534,501497888,2246,785421,17879,333,5686,52764899,13326,49366211,-11,7,45,-28,-27,5,20.37,9.9,3.261111,17.116667,0.0762,4.172222,67.722695
3/26/2022,61451,219,565023,20894379,167753,502062911,2137,787558,17819,345,10716,52775615,18803,49385014,-12,9,48,-19,-8,0,20.37,9.472222,3.294444,16.311111,0,5.044444,73.928128
3/27/2022,68335,228,596444,20962714,167981,502659493,2250,789808,18545,344,7627,52783242,8042,49393056,-10,0,45,-17,-4,-1,20.37,9.65,2.161111,16.1,0,4.927778,72.621483
3/28/2022,92852,230,733949,21055566,168211,503450392,2560,792368,19314,363,4823,52788065,10970,49404026,-14,2,33,-31,-28,7,20.37,8.455556,6.316667,11.2,0.719667,6.966667,90.438977
3/29/2022,80127,246,723268,21135693,168457,504271332,2562,794930,19561,365,4865,52792930,11424,49415450,-18,1,16,-32,-27,7,20.37,7.094444,4.838889,10.377778,2.975429,5.616667,90.363037
3/30/2022,73640,243,718329,21209333,168700,505034488,2688,797618,19700,359,5513,52798443,12584,49428034,-18,0,5,-34,-26,7,20.37,1.894444,-0.6,5.227778,2.582333,0.044444,87.673489
3/31/2022,54782,259,646488,21264115,168959,505745305,2429,800047,19748,356,5035,52803478,12548,49440582,-16,2,8,-33,-26,7,20.37,1.105556,-1.183333,4.483333,1.481667,-1.227778,84.584945
4/1/2022,47462,255,602173,21311577,169214,506391000,2148,802195,20083,352,4992,52808470,11708,49452290,-16,2,11,-31,-25,6,20.37,1.961111,-0.811111,6.333333,2.243667,-0.738889,82.450305
4/2/2022,37584,283,438301,21349161,169497,506829301,2084,804279,19740,350,10890,52819360,16918,49469208,-17,-2,9,-26,-8,2,20.37,2.35,-2.472222,7.033333,1.27,-1.288889,77.021862
4/3/2022,42170,266,455688,21391331,169763,507284989,2306,806585,20097,342,7500,52826860,9079,49478287,-14,-3,26,-21,-5,1,20.37,4.522222,-1.372222,9.15,0.381,0.288889,74.423596
4/4/2022,53716,251,577242,21445047,170014,507902196,2457,809042,20550,351,11137,52837997,10355,49488642,-17,0,13,-34,-31,7,20.37,10.016667,5.205556,12.322222,3.81,7.411111,84.315012
4/5/2022,49101,269,540210,21494148,170283,508510604,2595,811637,20534,364,11373,52849370,9877,49498519,-16,1,23,-33,-30,7,20.37,9.2,7.522222,10.783333,0.362857,6.561111,84.055918
4/6/2022,44744,274,530032,21538892,170557,509094199,2441,814078,20556,361,12369,52861739,10590,49509109,-16,-1,10,-34,-30,8,20.37,7.572222,4.438889,10.094444,3.640667,4.044444,78.962573
4/7/2022,38706,289,485790,21577598,170846,509627125,2267,816345,20462,357,11340,52873079,11097,49520206,-16,1,18,-33,-30,7,20.37,4.077778,1.188889,6.944444,8.170333,1.05,81.162219
4/8/2022,32981,302,447329,21610579,171148,510102005,2002,818347,20181,355,12200,52885279,11673,49531879,-13,5,27,-29,-30,6,20.37,3.027778,-2.494444,8.044444,0.508,-1.855556,70.832046
4/9/2022,27880,264,346756,21638459,171412,510448761,1906,820253,19607,367,25179,52910458,15933,49547812,-16,1,22,-21,-7,1,20.37,3.238889,-1.944444,7.75,0.254,-2.711111,65.478914
4/10/2022,30947,284,326339,21669406,171696,510775158,1995,822248,19751,372,15276,52925734,8900,49556712,-10,0,42,-17,-4,0,20.37,4.538889,-2.877778,9.661111,0.0254,-1.383333,65.551454
4/11/2022,37369,261,473685,21706775,171957,511278513,2117,824365,20189,379,15946,52941680,11969,49568681,-7,7,53,-30,-36,7,20.37,7.638889,3.894444,11.738889,0,2.15,68.552903
4/12/2022,33769,279,416194,21740544,172236,511722118,2247,826612,19887,385,17501,52959181,11541,49580222,-11,5,35,-32,-36,8,20.37,7.683333,5.327778,9.7,1.439333,6.411111,91.783852
4/13/2022,31681,295,417887,21772225,172531,512163743,2119,828731,19128,355,19404,52978585,12621,49592843,-7,6,51,-30,-36,7,20.37,9.805556,6.916667,13.427778,4.09575,7.3,84.791071
4/14/2022,26638,271,393622,21798863,172802,512580923,1902,830633,18604,349,22841,53001426,13397,49606240,1,17,74,-27,-38,5,20.37,10.605556,6.127778,15.388889,0,7.322222,80.404051
4/15/2022,21610,250,301587,21820473,173052,512882510,1651,832284,17903,320,11444,53012870,5516,49611756,-10,1,98,-37,-65,12,20.37,11.283333,6.461111,16.172222,0,8.077778,80.822249
4/16/2022,19918,257,258166,21840391,173309,513140676,1451,833735,17823,332,18165,53031035,11301,49623057,-20,4,61,-23,-16,1,20.37,11.922222,7.05,17.35,0,8.916667,81.996116
4/17/2022,20142,258,260955,21860533,173567,513401706,1491,835226,17654,328,4823,53035858,2643,49625700,-33,-39,76,-21,-17,0,20.37,12.5,7.85,17.044444,0,7.25,70.588751
4/18/2022,25215,252,335903,21885748,173819,513765456,1668,836894,17555,326,6040,53041898,3541,49629241,-5,-4,107,-42,-73,13,12.96,9.133333,4.377778,13.166667,1.669143,4.338889,72.458715
4/19/2022,25766,206,393357,21911514,174025,514216795,1626,838520,18005,336,15137,53057035,11105,49640346,-13,6,49,-31,-35,7,11.11,7.366667,2.105556,12.388889,0.056444,2.744444,72.611374
4/20/2022,21444,241,361720,21932958,174266,514600471,1511,840031,17463,349,14416,53071451,10974,49651320,-11,4,59,-30,-31,6,11.11,7.894444,2.372222,14.405556,0.3048,3.488889,73.951106
4/21/2022,18461,208,361689,21951419,174474,515004835,1440,841471,16520,338,17230,53088681,10706,49662026,-10,6,66,-29,-30,6,11.11,8.138889,3.227778,13.961111,0,3.961111,75.54106
4/22/2022,15696,216,329908,21967115,174690,515354593,1370,842841,15985,325,15821,53104502,10316,49672342,-13,5,38,-28,-30,6,11.11,9.055556,4.883333,14.794444,0,4.488889,73.331356
4/23/2022,13206,207,250549,21980321,174897,515605142,1208,844049,15170,325,31918,53136420,16861,49689203,-16,2,24,-21,-6,1,11.11,9.072222,5.316667,13.65,0,5.372222,77.878429
4/24/2022,14713,179,245010,21995034,175076,515850154,1191,845240,15061,324,15624,53152044,8241,49697444,-12,0,46,-16,-3,0,11.11,7.727778,4.144444,12.194444,0,3.944444,77.153646
4/25/2022,17099,189,386115,22012133,175265,516258347,1279,846519,14875,320,8959,53161003,7976,49705420,-12,6,30,-28,-25,5,11.11,6.388889,2.538889,10.027778,0,3.555556,82.374509
4/26/2022,14557,183,331187,22026690,175448,516665927,1259,847778,14183,326,9541,53170544,8424,49713844,-12,6,35,-26,-23,5,11.11,6.172222,2.45,9.788889,0.508,2.9,79.784768
4/27/2022,13049,191,312751,22039739,175639,516995770,1236,849014,13751,310,9609,53180153,8324,49722168,-12,6,24,-27,-23,5,11.11,5.516667,2.355556,8.677778,0.0762,0.194444,68.798845
4/28/2022,11599,186,315804,22051338,175825,517353077,1080,850094,13120,302,11079,53191232,9624,49731792,-10,8,33,-26,-23,5,11.11,5.388889,0.872222,8.933333,0,0.455556,70.750605
4/29/2022,10007,183,279737,22061345,176008,517650339,1006,851100,12550,305,11491,53202723,9533,49741325,-8,10,40,-24,-24,4,11.11,6.972222,-1.616667,14.044444,0,1.255556,67.05636
4/30/2022,8354,182,204510,22069699,176190,517854849,829,851929,12013,304,27465,53230188,15009,49756334,-10,4,42,-15,-6,-1,11.11,8.416667,0.677778,15.038889,0,3.294444,70.579454
